ARE	AA R
ARE(2)	ER
DO	D UW
EXIST?	EH G Z IH S T
FAR	F AA R
GOING?	G OW IH NG
HERE?	HH IH ER
HOW	HH AW
IS	IH Z
IT?	IH T
JOURNEY?	JH ER N IY
LIFE?	L AY F
MEANING	M IY N IH NG
NAME?	N EY M
OF	AH V
ON	AA N
ON(2)	AO N
THE	DH AH
THE(2)	DH IY
TIME	T AY M
WHAT	W AH T
WHAT(2)	HH W AH T
WHERE	W EH R
WHERE(2)	HH W EH R
WHY	W AY
WHY(2)	HH W AY
YOU	Y UW
YOU?	Y UW
YOUR	Y AO R
YOUR(2)	Y UH R
