ARE	AA R
ARE(2)	ER
FAR	F AA R
GOING	G OW IH NG
GOING(2)	G OW IH N
HOW	HH AW
IN	IH N
JUMP	JH AH M P
NAME	N EY M
SEATBELT	S IY T B EH L T
YOU	Y UW
YOUR	Y AO R
YOUR(2)	Y UH R
 ABOUT	AH B AW T
TALK	T AO K
YOURSELF	Y ER S EH L F
YOURSELF(2)	Y UH R S EH L F
YOURSELF(3)	Y AO R S EH L F AS	AE Z
AS(2)	EH Z
FAR	F AA R
GO	G OW
IT	IH T
MAKE	M EY K
OF	AH V
WISDOM	W IH Z D AH M
WORDS	W ER D Z

