ACHIEVEMENT	AH CH IY V M AH N T
ANYTHING	EH N IY TH IH NG
ARE	AA R
ARE(2)	ER
BIOMASS	B AY AH M AE S
EARTH	ER TH
GREATEST	G R EY T AH S T
HELLO	HH AH L OW
HELLO(2)	HH EH L OW
HOW	HH AW
INFLUENCE	IH N F L UW AH N S
IS	IH Z
OF	AH V
OLD	OW L D
PREVALENT	P R EH V AH L AH N T
RESTART	R IY S T AA R T
SCRIPT	S K R IH P T
SPECIES	S P IY SH IY Z
START	S T AA R T
THE	DH AH
THE(2)	DH IY
THIS	DH IH S
WHAT	W AH T
WHAT(2)	HH W AH T
WITH	W IH DH
WITH(2)	W IH TH
WORLD	W ER L D
