A	AH
A(2)	EY
CITY	S IH T IY
COME	K AH M
DID	D IH D
FROM	F R AH M
FROM(2)	F ER M
GAME	G EY M
IS	IH Z
LAST	L AE S T
LAST(2)	L AO S T
LAST(3)	L AE S
MOST	M OW S T
MOST(2)	M OW S
NA	N AA
NEH	N IY
NO	N OW
NOPE	N OW P
OK	OW K EY
PLAY	P L EY
RECENT	R IY S AH N T
STEERING	S T IH R IH NG
VISIT	V IH Z AH T
VISIT(2)	V IH Z IH T
WE	W IY
WHAT	W AH T
WHAT(2)	HH W AH T
WHEEL	W IY L
WHEEL(2)	HH W IY L
WHERE	W EH R
WHERE(2)	HH W EH R
WOULD	W UH D
YA	Y AA
YES	Y EH S
YOU	Y UW
YOUR	Y AO R
YOUR(2)	Y UH R
