ab	  qq a p 
abbauen	  qq a b au @ n 
aber	  qq aa: b ei 
abfälle	  qq a p f ee l @ 
abgaben	  qq a p g aa: b @ n 
abgebaut	  qq a p g @ b au t 
abgeben	  qq a p g e: b @ n 
abgebrochen	  qq a p g @ b r oo x @ n 
abgedeckt	  qq a p g @ d ee k t 
abgefallen	  qq a p g @ f a l @ n 
abgefunden	  qq a p g @ f uu n d @ n 
abgehalten	  qq a p g @ h a l t @ n 
abgehoben	  qq a p g @ h o: b @ n 
abgehört	  qq a p g @ h ui r t 
abgelaufen	  qq a p g @ l au f @ n 
abgelenkt	  qq a p g @ l ee nn k t 
abgelöst	  qq a p g @ l ui s t 
abgenommen	  qq a p g @ n oo m @ n 
abgerufen	  qq a p g @ qq r u: f @ n 
abgeschnitten	  qq a p g @ ss n ii t @ n 
abgesenkt	  qq a p g @ z ee nn k t 
abgesichert	  qq a p g @ z ii cc @ r t 
abgespeichert	  qq a p g @ ss p ai cc @ r t 
abgestempelt	  qq a p g @ ss t ee m p @ l t 
abgestürzt	  qq a p g @ ss t yy r t s t 
abgetötet	  qq a p g @ t ui: t @ t 
abgetreten	  qq a p g @ t r e: t @ n 
abgewählt	  qq a p g @ v e: l t 
abgewandert	  qq a p g @ v a n d @ r t 
abgewartet	  qq a p g @ v a r t @ t 
abgewaschen	  qq a p g @ v a ss @ n 
abgewendet	  qq a p g @ v ee n d @ t 
abgewertet	  qq a p g @ v ee r t @ t 
abgezogen	  qq a p g @ t s o: g @ n 
abhängig	  qq a p h ee nn ii cc 
abhängigkeit	  qq a p h ee nn ii cc k ai t 
abheben	  qq a p h e: b @ n 
abhebungen	  qq a p h e: b uu nn @ n 
abkassiert	  qq a p k a s i: r t 
ablehnen	  qq a p l e: n @ n 
ableiten	  qq a p l ai t @ n 
abliefern	  qq a p l i: f @ r n 
abnehmer	  qq a p n e: m ei 
abschluss	  qq a p ss l uu s 
abschreiben	  qq a p ss r ai b @ n 
abseits	  qq a p z ai t s 
absender	  qq a p z @ n d ei 
absicht	  qq a p z ii cc t 
absinken	  qq a p z ii nn k @ n 
absolut	  qq a p z o: l u: t 
absolvent	  qq a p z oo l v ee n t 
absprache	  qq a p ss p r aa: x @ 
abspringen	  qq a p ss p r ii nn @ n 
abständen	  qq a p ss t ee n d @ n 
absturz	  qq a p ss t uu r t s 
absturzes	  qq a p ss t uu r t s @ s 
absurde	  qq a p z uu r d @ 
abtreten	  qq a p t r e: t @ n 
abtropfen	  qq a p t r oo p f @ n 
abwarten	  qq a p v a r t @ n 
abwertend	  qq a p v ee r t @ n t 
abwertung	  qq a p v ee r t uu nn 
abwertungen	  qq a p v ee r t uu nn @ n 
acht	  qq a x t 
achten	  qq a x t @ n 
achtzehntausend	  qq a x t s e: n t au z @ n t 
achtzig	  qq a x t s ii cc 
adresse	  qq a d r @ s @ 
afrika	  qq a f r i: k aa: 
aggressivität	  qq a g r ee s i: v i: t ee: t 
ahnen	  qq aa: n @ n 
ähnlich	  qq e: n l ii cc 
Ähnliches	  qq e: n l ii cc @ s 
ahnung	  qq aa: n uu nn 
akkus	  qq a k uu s 
aktie	  qq a k t i: 
aktien	  qq a k t i: @ n 
aktienkurse	  qq a k t i: n k uu r z @ 
aktienmarkt	  qq a k t i: n m a r k t 
aktienmärkte	  qq a k t i: n m ee r k t @ 
aktionär	  qq a k t s ii o: n ee: r 
aktivitäten	  qq a k t i: v i: t ee: t @ n 
aktualisierung	  qq a k t u: a l i: z i: r uu nn 
aktuelle	  qq a k t u: ee l @ 
akzeptieren	  qq a k t s ee p t i: r @ n 
akzeptiert	  qq a k t s ee p t i: r t 
alarmiert	  qq a l a r m i: r t 
alle	  qq a l @ 
allein	  qq a l ai n 
alleine	  qq a l ai n @ 
allen	  qq a l @ n 
aller	  qq a l ei 
alles	  qq a l @ s 
allgemein	  qq a l g e: m ai n 
allgemeine	  qq a l g e: m ai n @ 
allgemeinen	  qq a l g e: m ai n @ n 
alltag	  qq a l t aa: k 
alpen	  qq a l p @ n 
als	  qq aa: l s 
alte	  qq a l t @ 
alten	  qq a l t @ n 
alter	  qq a l t ei 
älter	  qq ee l t ei 
alternative	  qq a l t ei n a t i: v @ 
alternativen	  qq a l t ei n a t i: v @ n 
altersversorgung	  qq a l t ei s v ei z oo r g uu nn 
altes	  qq a l t @ s 
aluminium	  qq a l u: m i: n i: uu m 
am	  qq a m 
ameisen	  qq a m ai z @ n 
amerika	  qq a m e: r i: k aa: 
amerikaner	  qq a m e: r i: k aa: n ei 
amt	  qq a m t 
an	  qq a n 
analogie	  qq a n a l o: g i: 
analyse	  qq a n a l y: z @ 
analysen	  qq a n a l y: z @ n 
analysieren	  qq a n a l y: z i: r @ n 
anbieter	  qq a n b i: t ei 
andere	  qq a n d @ r @ 
anderen	  qq a n d @ r @ n 
anderer	  qq a n d @ r ei 
anderes	  qq a n d @ r @ s 
ändern	  qq ee n d @ r n 
anders	  qq a n d ei s 
ändert	  qq ee n d @ r t 
Änderungen	  qq ee n d @ r uu nn @ n 
anekdote	  qq a n qq ee k d o: t @ 
anerkannt	  qq a n qq ee r k a n t 
anfang	  qq a n f a nn 
anfangen	  qq a n f a nn @ n 
anforderungen	  qq a n f oo r d @ r uu nn @ n 
angebaut	  qq a n g @ b au t 
angebot	  qq a n g @ b o: t 
angebote	  qq a n g @ b o: t @ 
angeboten	  qq a n g @ b o: t @ n 
angebrochen	  qq a n g @ b r oo x @ n 
angefacht	  qq a n g @ f a x t 
angefordert	  qq a n g @ f oo r d @ r t 
angeführt	  qq a n g @ f y: r t 
angehalten	  qq a n g @ h a l t @ n 
angehoben	  qq a n g @ h o: b @ n 
angeklagt	  qq a n g @ k l aa: k t 
angekündigt	  qq a n g @ k yy n d ii cc t 
angekurbelt	  qq a n g @ k uu r b @ l t 
angelegenheit	  qq a n g @ l e: g @ n h ai t 
angemeldet	  qq a n g @ m ee l d @ t 
angemessen	  qq a n g @ m ee s @ n 
angenehm	  qq a n g @ n e: m 
angenommen	  qq a n g @ n oo m @ n 
angepasst	  qq a n g @ p a s t 
angeschlossen	  qq a n g @ ss l oo s @ n 
angesehen	  qq a n g @ z e: @ n 
angespannt	  qq a n g @ ss p a n t 
angesprochen	  qq a n g @ ss p r oo x @ n 
angestellt	  qq a n g @ ss t ee l t 
angestellten	  qq a n g @ ss t ee l t @ n 
angestellter	  qq a n g @ ss t ee l t ei 
angestiegen	  qq a n g @ ss t i: g @ n 
angestrengt	  qq a n g @ ss t r ee nn t 
angewachsen	  qq a n g @ v a k s @ n 
angewendet	  qq a n g @ v ee n d @ t 
angewiesen	  qq a n g @ v i: z @ n 
angezogen	  qq a n g @ t s o: g @ n 
angst	  qq a nn s t 
anhänger	  qq a n h ee nn ei 
anhebung	  qq a n h e: b uu nn 
ankommt	  qq a n k oo m t 
anlage	  qq a n l aa: g @ 
anlegen	  qq a n l e: g @ n 
anlehnen	  qq a n l e: n @ n 
annehmen	  qq a n n e: m @ n 
anpassen	  qq a n p a s @ n 
anregung	  qq a n qq r e: g uu nn 
anrufen	  qq a n qq r u: f @ n 
anrühren	  qq a n qq r y: r @ n 
ansatz	  qq a n z a t s 
anschauen	  qq a n ss au @ n 
ansehen	  qq a n z e: @ n 
anspruch	  qq a n ss p r uu x 
ansprüche	  qq a n ss p r yy cc @ 
ansprüchen	  qq a n ss p r yy cc @ n 
anspruchsdenken	  qq a n ss p r uu x s d ee nn k @ n 
anteil	  qq a n t ai l 
anteile	  qq a n t ai l @ 
antwort	  qq a n t v oo r t 
antworten	  qq a n t v oo r t @ n 
anwesend	  qq a n v e: z @ n t 
anzeige	  qq a n t s ai g @ 
anzutreffen	  qq a n t s u: t r ee f @ n 
apfelsaft	  qq a p f @ l z a f t 
apfelsorte	  qq a p f @ l s qq oo r t @ 
apfelwein	  qq a p f @ l v ai n 
apparat	  qq a p a r aa: t 
arbeit	  qq a r b ai t 
arbeiten	  qq a r b ai t @ n 
arbeiter	  qq a r b ai t ei 
arbeitet	  qq a r b ai t @ t 
arbeitgeber	  qq a r b ai t g e: b ei 
arbeitskosten	  qq a r b ai t s k oo s t @ n 
arbeitslosigkeit	  qq a r b ai t s l o: z ii cc k ai t 
arbeitsplatz	  qq a r b ai t s p l a t s 
arbeitsplätze	  qq a r b ai t s p l ee t s @ 
arbeitsstelle	  qq a r b ai t s ss t ee l @ 
archiv	  qq a r cc i: f 
Ärgernis	  qq ee r g ei n ii s 
argumente	  qq a r g u: m ee n t @ 
ärmer	  qq ee r m ei 
armut	  qq a r m u: t 
aromastoffe	  qq a r o: m a s t oo f @ 
art	  qq a r t 
arten	  qq a r t @ n 
artikel	  qq a r t i: k @ l 
arzt	  qq a r t s t 
ascorbinsäure	  qq a s k oo r b ii n z oy r @ 
asiatischen	  qq a z i: aa: t ii ss @ n 
attraktivität	  qq a t r a k t i: v i: t ee: t 
attribute	  qq a t r i: b u: t @ 
auch	  qq au x 
auf	  qq au f 
aufbewahren	  qq au f b @ v aa: r @ n 
aufbewahrt	  qq au f b @ v aa: r t 
aufbewahrung	  qq au f b @ v aa: r uu nn 
aufgabe	  qq au f g aa: b @ 
aufgaben	  qq au f g aa: b @ n 
aufgebaut	  qq au f g @ b au t 
aufgebläht	  qq au f g @ b l e: t 
aufgefallen	  qq au f g @ f a l @ n 
aufgegeben	  qq au f g @ g e: b @ n 
aufgegriffen	  qq au f g @ g r ii f @ n 
aufgehoben	  qq au f g @ h o: b @ n 
aufgehört	  qq au f g @ h ui r t 
aufgekauft	  qq au f g @ k au f t 
aufgeklärt	  qq au f g @ k l ee r t 
aufgelöst	  qq au f g @ l ui s t 
aufgenommen	  qq au f g @ n oo m @ n 
aufgepresst	  qq au f g @ p r ee s t 
aufgestiegen	  qq au f g @ ss t i: g @ n 
aufgesucht	  qq au f g @ z u: x t 
aufgetaucht	  qq au f g @ t au x t 
aufgeteilt	  qq au f g @ t ai l t 
aufgetreten	  qq au f g @ t r e: t @ n 
aufgewendet	  qq au f g @ v ee n d @ t 
aufgezeigt	  qq au f g @ t s ai k t 
aufhalten	  qq au f h a l t @ n 
aufhören	  qq au f h ui: r @ n 
aufkommen	  qq au f k oo m @ n 
aufmerksam	  qq au f m ee r k z aa: m 
aufnehmen	  qq au f n e: m @ n 
aufschwung	  qq au f ss v uu nn 
aufträge	  qq au f t r ee: g @ 
aufträgen	  qq au f t r ee: g @ n 
auftreten	  qq au f t r e: t @ n 
auftrieb	  qq au f t r i: p 
aufwertung	  qq au f v ee r t uu nn 
august	  qq au g uu s t 
aus	  qq au s 
ausbildung	  qq au s b ii l d uu nn 
ausbrechen	  qq au s b r ee cc @ n 
ausdruck	  qq au s d r uu k 
ausdrucken	  qq au s d r uu k @ n 
auseinandergesetzt	  qq au z qq ai n a n d ei g e: z ee t s t 
ausfallen	  qq au s f a l @ n 
ausgaben	  qq au s g aa: b @ n 
ausgeben	  qq au s g e: b @ n 
ausgebildet	  qq au s g @ b ii l d @ t 
ausgebrochen	  qq au s g @ b r oo x @ n 
ausgedrückt	  qq au s g @ d r yy k t 
ausgegangen	  qq au s g @ g a nn @ n 
ausgegeben	  qq au s g @ g e: b @ n 
ausgehen	  qq au s g e: @ n 
ausgelassene	  qq au s g @ l a s @ n @ 
ausgelastet	  qq au s g @ l a s t @ t 
ausgeliefert	  qq au s g @ l i: f @ r t 
ausgelöst	  qq au s g @ l ui s t 
ausgenutzt	  qq au s g @ n uu t s t 
ausgeprägt	  qq au s g @ p r ee: k t 
ausgereicht	  qq au s g @ qq r ai cc t 
ausgeschlossen	  qq au s g @ ss l oo s @ n 
ausgesetzt	  qq au s g @ z ee t s t 
ausgesorgt	  qq au s g @ z oo r k t 
ausgestiegen	  qq au s g @ ss t i: g @ n 
ausgestopft	  qq au s g @ ss t oo p f t 
ausgetreten	  qq au s g @ t r e: t @ n 
ausgewählt	  qq au s g @ v e: l t 
ausgeweitet	  qq au s g @ v ai t @ t 
ausgezeichnet	  qq au s g @ t s ai cc n @ t 
ausgleichen	  qq au s g l ai cc @ n 
aushalten	  qq au s h a l t @ n 
auskennen	  qq au s k ee n @ n 
auskommen	  qq au s k oo m @ n 
ausland	  qq au s l a n t 
ausländer	  qq au s l ee n d ei 
auslieferung	  qq au s l i: f @ r uu nn 
auslösen	  qq au s l ui: z @ n 
ausnahmen	  qq au s n aa: m @ n 
ausnutzen	  qq au s n uu t s @ n 
ausreichen	  qq au s qq r ai cc @ n 
ausreichend	  qq au s qq r ai cc @ n t 
ausreichende	  qq au s qq r ai cc @ n d @ 
ausreichenden	  qq au s qq r ai cc @ n d @ n 
aussage	  qq au s z aa: g @ 
aussagen	  qq au s z aa: g @ n 
ausscheiden	  qq au s ss ai d @ n 
ausschließlich	  qq au s ss l i: s l ii cc 
aussehen	  qq au s z e: @ n 
außenseiter	  qq au s @ n z ai t ei 
außerdem	  qq au s ei d e: m 
aussicht	  qq au s z ii cc t 
aussprechen	  qq au s ss p r ee cc @ n 
aussteigen	  qq au s ss t ai g @ n 
austausch	  qq au s t au ss 
austauschbar	  qq au s t au ss b aa: r 
australien	  qq au s t r a l ii @ n 
austritt	  qq au s t r ii t 
ausweg	  qq au s v e: k 
auswege	  qq au s v e: g @ 
ausweichend	  qq au s v ai cc @ n t 
ausweichmöglichkeiten	  qq au s v ai cc m ui g l ii cc k ai t @ n 
auswirkung	  qq au s v ii r k uu nn 
auswirkungen	  qq au s v ii r k uu nn @ n 
auszahlen	  qq au s t s aa: l @ n 
auto	  qq au t o: 
autoindustrie	  qq au t o: ii n d uu s t r i: 
automatisch	  qq au t o: m aa: t ii ss 
autoren	  qq au t o: r @ n 
autos	  qq au t o: s 
bakterien	  b a k t e: r ii @ n 
bald	  b a l t 
bank	  b a nn k 
banken	  b a nn k @ n 
banknote	  b a nn k n o: t @ 
banknoten	  b a nn k n o: t @ n 
bankrott	  b a nn k r oo t 
bargeld	  b a r g ee l t 
basiert	  b a z i: r t 
basis	  b a z ii s 
batterien	  b a t e: r i: @ n 
bau	  b au 
baumärkten	  b au m ee r k t @ n 
beachten	  b @ qq a x t @ n 
beachtet	  b @ qq a x t @ t 
beachtlich	  b @ qq a x t l ii cc 
beantwortet	  b @ qq a n t v oo r t @ t 
bedanken	  b @ d a nn k @ n 
bedarf	  b @ d a r f 
bedauerliche	  b @ d au ei l ii cc @ 
bedauern	  b @ d au @ r n 
bedeuten	  b @ d oy t @ n 
bedeutet	  b @ d oy t @ t 
bedeutung	  b @ d oy t uu nn 
bedrängnis	  b @ d r ee nn n ii s 
bedroht	  b @ d r o: t 
beeinflusst	  b @ qq ai n f l uu s t 
befall	  b @ f a l 
befallen	  b @ f a l @ n 
befalls	  b @ f a l s 
befinden	  b @ f ii n d @ n 
befindet	  b @ f ii n d @ t 
befristungen	  b @ f r ii s t uu nn @ n 
befürchten	  b @ f yy r cc t @ n 
befürchtet	  b @ f yy r cc t @ t 
begehrlichkeit	  b @ g e: r l ii cc k ai t 
begeistert	  b @ g ai s t @ r t 
beginn	  b @ g ii n 
beginnen	  b @ g i: n @ n 
begleichen	  b @ g l ai cc @ n 
beglichen	  b e: g l ii cc @ n 
begonnen	  b @ g oo n @ n 
begreifen	  b @ g r ai f @ n 
begrenzen	  b @ g r ee n t s @ n 
begrenzt	  b @ g r ee n t s t 
begriff	  b @ g r ii f 
begriffen	  b @ g r ii f @ n 
begründet	  b @ g r yy n d @ t 
begründung	  b @ g r yy n d uu nn 
behälter	  b @ h ee l t ei 
behandelt	  b @ h a n d @ l t 
behandlung	  b @ h a n d l uu nn 
behandlungen	  b @ h a n d l uu nn @ n 
behaupten	  b @ h au p t @ n 
bei	  b ai 
beide	  b ai d @ 
beiden	  b ai d @ n 
beides	  b ai d @ s 
beim	  b ai m 
beispiel	  b ai ss p i: l 
beispiele	  b ai ss p i: l @ 
beitrag	  b ai t r aa: k 
beiträge	  b ai t r ee: g @ 
bekämpfung	  b @ k ee m p f uu nn 
bekannt	  b @ k a n t 
bekannte	  b @ k a n t @ 
bekannten	  b @ k a n t @ n 
bekomme	  b @ k oo m @ 
bekommen	  b @ k oo m @ n 
bekommt	  b @ k oo m t 
belastungen	  b @ l a s t uu nn @ n 
belegt	  b @ l e: k t 
beliebt	  b @ l i: p t 
beliebter	  b @ l i: b t ei 
bemerkbar	  b @ m ee r k b aa: r 
bemerkenswerten	  b @ m ee r k @ n s v ee r t @ n 
bemühen	  b @ m y: @ n 
benötigen	  b @ n ui: t ii g @ n 
benötigt	  b @ n ui: t ii cc t 
benötigte	  b @ n ui: t ii cc t @ 
benutzen	  b @ n uu t s @ n 
benzin	  b ee n t s ii n 
beraten	  b @ qq r aa: t @ n 
berater	  b @ qq r aa: t ei 
beratung	  b @ qq r a t uu nn 
berechnet	  b @ qq r ee cc n @ t 
berechnungen	  b @ qq r ee cc n uu nn @ n 
bereich	  b @ qq r ai cc 
bereiche	  b @ qq r ai cc @ 
bereichen	  b @ qq r ai cc @ n 
bereit	  b @ qq r ai t 
bereitet	  b @ qq r ai t @ t 
bereits	  b @ qq r ai t s 
bericht	  b @ qq r ii cc t 
berichte	  b @ qq r ii cc t @ 
berichtet	  b @ qq r ii cc t @ t 
berücksichtigt	  b @ qq r yy k s ii cc t ii cc t 
beruflich	  b @ qq r u: f l ii cc 
beruflicher	  b @ qq r u: f l ii cc ei 
beruhigt	  b @ qq r u: ii cc t 
beruht	  b @ qq r u: t 
beschäftigen	  b @ ss ee f t ii g @ n 
beschäftigt	  b @ ss ee f t ii cc t 
bescheiden	  b @ ss ai d @ n 
beschlagnahmt	  b @ ss l a g n aa: m t 
beschleunigt	  b @ ss l oy n ii cc t 
beschlussfassung	  b @ ss l uu s f a s uu nn 
beschränken	  b @ ss r ee nn k @ n 
beschreiben	  b @ ss r ai b @ n 
beschreibung	  b @ ss r ai b uu nn 
beschrieben	  b @ ss r i: b @ n 
beschwert	  b @ ss v e: r t 
besitzen	  b @ z ii t s @ n 
besitzer	  b @ z ii t s ei 
besondere	  b @ z oo n d @ r @ 
besonderes	  b @ z oo n d @ r @ s 
besonders	  b @ z oo n d ei s 
besorgen	  b @ z oo r g @ n 
besorgt	  b @ z oo r k t 
besser	  b ee s ei 
bessere	  b ee s @ r @ 
besseres	  b ee s @ r @ s 
bestandteil	  b @ ss t a n t ai l 
bestätigen	  b @ ss t ee: t ii g @ n 
beste	  b ee s t @ 
bestehen	  b @ ss t e: @ n 
bestehenden	  b @ ss t e: @ n d @ n 
besteht	  b @ ss t e: t 
bestellung	  b @ ss t ee l uu nn 
bestens	  b ee ss t @ n s 
bestimmt	  b @ ss t ii m t 
bestimmte	  b @ ss t ii m t @ 
bestimmten	  b @ ss t ii m t @ n 
bestraft	  b @ ss t r a f t 
bestritten	  b @ ss t r ii t @ n 
beteiligten	  b @ t ai l ii cc t @ n 
betrachten	  b @ t r a x t @ n 
betrachtet	  b @ t r a x t @ t 
betrag	  b @ t r aa: k 
betragen	  b @ t r aa: g @ n 
beträgt	  b @ t r ee: k t 
betreffen	  b @ t r ee f @ n 
betreuung	  b @ t r oy uu nn 
betriebe	  b @ t r i: b @ 
betrieben	  b @ t r i: b @ n 
betroffen	  b @ t r oo f @ n 
betrug	  b @ t r u: k 
beurteilen	  b @ qq uu r t ai l @ n 
bevölkerung	  b @ f ui l k @ r uu nn 
bevorzugt	  b @ f o: r t s u: k t 
bewachen	  b @ v a x @ n 
bewährt	  b @ v e: r t 
bewährungsstrafe	  b @ v e: r uu nn s ss t r aa: f @ 
bewegt	  b @ v e: k t 
beweis	  b @ v ai s 
beweise	  b @ v ai z @ 
beweist	  b @ v ai s t 
bewerten	  b @ v ee r t @ n 
bewertet	  b @ v ee r t @ t 
bewiesen	  b @ v i: z @ n 
bezahlen	  b @ t s aa: l @ n 
bezahlt	  b @ t s aa: l t 
bezahlung	  b @ t s aa: l uu nn 
bezeichnet	  b @ t s ai cc n @ t 
bezeichnung	  b @ t s ai cc n uu nn 
bezweifelt	  b @ t s v ai f @ l t 
bieten	  b i: t @ n 
bietet	  b i: t @ t 
bilanz	  b i: l a n t s 
bild	  b ii l t 
bilden	  b ii l d @ n 
bildes	  b ii l d @ s 
bildungsabschluss	  b ii l d uu nn s qq a b ss l uu s 
billig	  b ii l ii cc 
billiger	  b ii l ii g ei 
billiges	  b ii l ii g @ s 
bin	  b ii n 
bindung	  b ii n d uu nn 
bis	  b ii s 
bisher	  b ii ss ei 
bisherige	  b ii s h @ r ii g @ 
bisschen	  b ii s cc @ n 
bitte	  b ii t @ 
blamabel	  b l a m aa: b @ l 
bleiben	  b l ai b @ n 
bleibt	  b l ai p t 
blick	  b l ii k 
blind	  b l ii n t 
blüten	  b l y: t @ n 
boden	  b o: d @ n 
bohnen	  b o: n @ n 
bonität	  b o: n i: t ee: t 
boot	  b o: t 
börse	  b ui r z @ 
botanik	  b o: t a n i: k 
boten	  b o: t @ n 
box	  b oo k s 
brachte	  b r a x t @ 
brauchen	  b r au x @ n 
braucht	  b r au x t 
brennstoff	  b r ee n s t oo f 
bricht	  b r ii cc t 
brief	  b r i: f 
bringt	  b r ii nn t 
brotgetreide	  b r oo t g ee t r ai d @ 
brotlose	  b r oo t l o: z @ 
bruchteil	  b r uu x t ai l 
bruder	  b r u: d ei 
bruttoinlandsprodukt	  b r uu t o: ii n l a n d s p r o: d uu k t 
buch	  b uu x 
bücher	  b yy cc ei 
buchstaben	  b uu x s t aa: b @ n 
bunte	  b uu n t @ 
bürger	  b yy r g ei 
bürgern	  b yy r g @ r n 
bürokraten	  b y: r oo k r aa: t @ n 
bürokratie	  b y: r oo k r a t i: 
bürokratischer	  b y: r oo k r aa: t ii ss ei 
chance	  t ss a n s 
chancen	  cc a n k @ n 
chaos	  cc a o: s 
charakter	  cc a r a k t ei 
chemische	  cc e: m ii ss @ 
china	  cc i: n aa: 
chinesen	  cc i: n e: z @ n 
clever	  k l e: v ei 
computer	  k @ m p j u: t ei 
da	  d aa: 
dabei	  d a b ai 
dadurch	  d aa: d uu r x 
dafür	  d a f y: r 
dagegen	  d a g e: g @ n 
daher	  d aa: h ee r 
dahinter	  d aa: ii n t ei 
damals	  d a m aa: l s 
damit	  d aa: m ii t 
danach	  d a n a x 
daneben	  d a n e: b @ n 
dank	  d a nn k 
dann	  d a n 
dar	  d aa: r 
daran	  d aa: r a n 
darauf	  d a r au f 
daraus	  d a r au s 
darf	  d a r f 
dargestellt	  d a r g ee s t ee l t 
darstellen	  d a r s t ee l @ n 
darüber	  d a r y: b ei 
darum	  d a r uu m 
darunter	  d a r uu n t ei 
das	  d a s 
dass	  d a s 
datei	  d a t ai 
dateien	  d a t ai @ n 
daten	  d aa: t @ n 
dauer	  d au ei 
dauerhaft	  d au ei h a f t 
dauern	  d au @ r n 
dauernd	  d au @ r n t 
davon	  d aa: f oo n 
davor	  d a v o: r 
dazu	  d aa: t s u: 
dazwischen	  d a t s v ii ss @ n 
decken	  d ee k @ n 
deckung	  d ee k uu nn 
defensiv	  d e: f ee n z i: f 
definieren	  d e: f i: n i: r @ n 
definiert	  d e: f i: n i: r t 
definition	  d e: f i: n i: t s ii o: n 
defizit	  d e: f i: t s ii t 
deflation	  d ee f l a t s ii o: n 
degradiert	  d ee g r a d i: r t 
deklaration	  d ee k l a r a t s ii o: n 
dem	  d e: m 
demokratien	  d e: m o: k r a t i: @ n 
demonstriert	  d e: m oo n s t r i: r t 
den	  d e: n 
denen	  d e: n @ n 
denkbar	  d ee nn k b aa: r 
denken	  d ee nn k @ n 
denn	  d ee n 
depression	  d ee p r ee s j o: n 
der	  d ee r 
deren	  d ee r @ n 
derivate	  d e: r i: v aa: t @ 
derzeit	  d ee r t s ai t 
derzeitigen	  d ee r t s ai t ii g @ n 
des	  d ee s 
deswegen	  d ee s v e: g @ n 
deutlich	  d oy t l ii cc 
deutliche	  d oy t l ii cc @ 
deutlichem	  d oy t l ii cc @ m 
deutlichen	  d oy t l ii cc @ n 
deutschland	  d oy t ss l a n t 
dicht	  d ii cc t 
die	  d i: 
dienste	  d i: n s t @ 
dient	  d i: n t 
dies	  d i: z 
diesbezüglich	  d i: s b e: t s y: g l ii cc 
diese	  d i: z @ 
diesem	  d i: z @ m 
diesen	  d i: z @ n 
dieser	  d i: z ei 
dieses	  d i: z @ s 
differenz	  d ii f e: r ee n t s 
diktierkürzel	  d ii k t i: r k yy r t s @ l 
dinge	  d ii nn @ 
dingen	  d ii nn @ n 
dir	  d i: r 
direkt	  d i: r ee k t 
diskette	  d ii s k ee t @ 
diskussion	  d ii s k uu s j o: n 
diskussionen	  d ii s k uu s j o: n @ n 
disziplin	  d ii s t s ii p l i: n 
dividende	  d i: v i: d @ n d @ 
doch	  d oo x 
dokument	  d o: k u: m ee n t 
dokumente	  d o: k u: m ee n t @ 
dollar	  d oo l aa: r 
dollars	  d oo l aa: r s 
dominosteine	  d o: m i: n oo s t ai n @ 
doppelt	  d oo p @ l t 
dort	  d oo r t 
dorthin	  d oo r t h ii n 
dortige	  d oo r t ii g @ 
dose	  d o: z @ 
dosen	  d o: z @ n 
dran	  d r aa: n 
drei	  d r ai 
dreihundert	  d r ai h uu n d @ r t 
dreihunderttausend	  d r ai h uu n d ei t au z @ n t 
dreiundzwanzig	  d r ai uu n d t s v a n t s ii cc 
dringend	  d r ii nn @ n t 
dritte	  d r ii t @ 
drohen	  d r o: @ n 
droht	  d r o: t 
druck	  d r uu k 
drucken	  d r uu k @ n 
du	  d u: 
durch	  d uu r cc 
durchaus	  d uu r cc qq au s 
durchblick	  d uu r cc b l ii k 
durcheinander	  d uu r cc qq ai n a n d ei 
durchfahren	  d uu r cc f aa: r @ n 
durchführen	  d uu r cc f y: r @ n 
durchgedrückt	  d uu r cc g @ d r yy k t 
durchgeführt	  d uu r cc g @ f y: r t 
durchgesetzt	  d uu r cc g @ z ee t s t 
durchhalten	  d uu r cc h a l t @ n 
durchlesen	  d uu r cc l e: z @ n 
durchrühren	  d uu r cc qq r y: r @ n 
durchschnittlich	  d uu r cc ss n ii t l ii cc 
durchsetzen	  d uu r cc z ee t s @ n 
durchzuhalten	  d uu r cc t s u: h a l t @ n 
dürfen	  d yy r f @ n 
durfte	  d uu r f t @ 
dürfte	  d yy r f t @ 
dynamischer	  d y: n a m ii ss ei 
ebene	  qq e: b @ n @ 
ebenen	  qq e: b @ n @ n 
ebenfalls	  qq e: b @ n f a l s 
ecke	  qq ee k @ 
effekt	  qq ee f ee k t 
effizient	  qq ee f i: t s ii ee n t 
effizienz	  qq ee f i: t s ii ee n t s 
egal	  qq e: g aa: l 
ehemaligen	  qq e: e: m a l ii g @ n 
eher	  qq e: ei 
eier	  qq ai ei 
eigene	  qq ai g @ n @ 
eigenen	  qq ai g @ n @ n 
eigener	  qq ai g @ n ei 
eigenschaften	  qq ai g @ n ss a f t @ n 
eigentlich	  qq ai g @ n t l ii cc 
eigentliche	  qq ai g @ n t l ii cc @ 
eigentum	  qq ai g @ n t u: m 
eigentümer	  qq ai g @ n t y: m ei 
eile	  qq ai l @ 
ein	  qq ai n 
einbehalten	  qq ai n b @ h a l t @ n 
einbrechen	  qq ai n b r ee cc @ n 
einbruch	  qq ai n b r uu x 
einbrüche	  qq ai n b r yy cc @ 
eindecken	  qq ai n d ee k @ n 
eindeutig	  qq ai n d oy t ii cc 
eindringen	  qq ai n d r ii nn @ n 
eindruck	  qq ai n d r uu k 
eindrücklich	  qq ai n d r yy k l ii cc 
eindrucksvoll	  qq ai n d r uu k s f oo l 
eine	  qq ai n @ 
einem	  qq ai n @ m 
einen	  qq ai n @ n 
einer	  qq ai n ei 
eines	  qq ai n @ s 
einfach	  qq ai n f a x 
einfache	  qq ai n f a x @ 
einfacher	  qq ai n f a x ei 
einfaches	  qq ai n f a x @ s 
einfluss	  qq ai n f l uu s 
einfordern	  qq ai n f oo r d @ r n 
einfrieren	  qq ai n f r i: r @ n 
eingebaut	  qq ai n g @ b au t 
eingebrochen	  qq ai n g @ b r oo x @ n 
eingedämmt	  qq ai n g @ d ee m t 
eingefahren	  qq ai n g @ f aa: r @ n 
eingeführt	  qq ai n g @ f y: r t 
eingefüllt	  qq ai n g @ f yy l t 
eingegangen	  qq ai n g @ g a nn @ n 
eingehalten	  qq ai n g @ h a l t @ n 
eingehen	  qq ai n g e: @ n 
eingeholt	  qq ai n g @ h oo l t 
eingejagt	  qq ai n g @ j aa: k t 
eingeladen	  qq ai n g @ l aa: d @ n 
eingelassen	  qq ai n g @ l a s @ n 
eingerechnet	  qq ai n g @ qq r ee cc n @ t 
eingeredet	  qq ai n g @ r e: d @ t 
eingereicht	  qq ai n g @ qq r ai cc t 
eingerichtet	  qq ai n g @ qq r ii cc t @ t 
eingeschränkt	  qq ai n g @ ss r ee nn k t 
eingesetzt	  qq ai n g @ z ee t s t 
eingespart	  qq ai n g @ ss p a r t 
eingestellt	  qq ai n g @ ss t ee l t 
eingestiegen	  qq ai n g @ ss t i: g @ n 
eingetreten	  qq ai n g @ t r e: t @ n 
eingetrichtert	  qq ai n g @ t r ii cc t @ r t 
eingetrieben	  qq ai n g @ t r i: b @ n 
eingetroffen	  qq ai n g @ t r oo f @ n 
einholen	  qq ai n h o: l @ n 
einig	  qq ai n ii cc 
einige	  qq ai n ii g @ 
einigen	  qq ai n ii g @ n 
einiger	  qq ai n ii g ei 
einigermaßen	  qq ai n ii g ei m aa: s @ n 
einiges	  qq ai n ii g @ s 
einkauf	  qq ai n k au f 
einkaufen	  qq ai n k au f @ n 
einkommen	  qq ai n k oo m @ n 
einkommens	  qq ai n k oo m @ n s 
einlagen	  qq ai n l aa: g @ n 
einmal	  qq ai n m aa: l 
einnahmen	  qq ai n n aa: m @ n 
einrichtung	  qq ai n qq r ii cc t uu nn 
eins	  qq ai n s 
einsatz	  qq ai n z a t s 
einsatzmöglichkeiten	  qq ai n z a t s m ui g l ii cc k ai t @ n 
einseitig	  qq ai n z ai t ii cc 
einsetzbar	  qq ai n z ee t s b aa: r 
einsetzen	  qq ai n z ee t s @ n 
einsteigen	  qq ai n ss t ai g @ n 
eintreten	  qq ai n t r e: t @ n 
einverstanden	  qq ai n f ee r ss t a n d @ n 
einzahlen	  qq ai n t s aa: l @ n 
einzelfälle	  qq ai n t s ee l f ee l @ 
einzelheiten	  qq ai n t s ee l h ai t @ n 
einzeln	  qq ai n t s ee l n 
einzelne	  qq ai n t s ee l n @ 
einzelnen	  qq ai n t s ee l n @ n 
einzige	  qq ai n t s i: g @ 
einzigen	  qq ai n t s i: g @ n 
einziges	  qq ai n t s i: g @ s 
einzukaufen	  qq ai n t s u: k au f @ n 
eiweiß	  qq ai v ai s 
elegante	  qq e: l e: g a n t @ 
element	  qq e: l e: m ee n t 
elite	  qq e: l i: t @ 
eliten	  qq e: l i: t @ n 
empfang	  qq ee m p f a nn 
empfänger	  qq ee m p f ee nn ei 
empfehlen	  qq ee m p f e: l @ n 
empfehlung	  qq ee m p f e: l uu nn 
empfehlungen	  qq ee m p f e: l uu nn @ n 
empfindlich	  qq ee m p f ii n d l ii cc 
empfohlen	  qq ee m p f o: l @ n 
ende	  qq ee n d @ 
enden	  qq ee n d @ n 
endgültig	  qq ee n t g yy l t ii cc 
england	  qq ee nn l a n t 
englisch	  qq ee nn l ii ss 
engpass	  qq ee nn p a s 
enorm	  qq e: n oo r m 
enormes	  qq e: n oo r m @ s 
enteignung	  qq ee n t qq ai g n uu nn 
entfallen	  qq ee n t f a l @ n 
entfernen	  qq ee n t f ee r n @ n 
entfernt	  qq ee n t f ee r n t 
entfernung	  qq ee n t f ee r n uu nn 
entgehen	  qq ee n t g e: @ n 
enthält	  qq ee n t h ee l t 
enthalten	  qq ee n t h a l t @ n 
entlassen	  qq ee n t l a s @ n 
entmutigt	  qq ee n t m u: t ii cc t 
entscheiden	  qq ee n t ss ai d @ n 
entscheidendes	  qq ee n t ss ai d @ n d @ s 
entscheidet	  qq ee n t ss ai d @ t 
entscheidung	  qq ee n t ss ai d uu nn 
entscheidungen	  qq ee n t ss ai d uu nn @ n 
entschieden	  qq ee n t ss i: d @ n 
entschluss	  qq ee n t ss l uu s 
entschuldigt	  qq ee n t ss uu l d ii cc t 
entsprechend	  qq ee n t ss p r ee cc @ n t 
entsprechenden	  qq ee n t ss p r ee cc @ n d @ n 
entspricht	  qq ee n t ss p r ii cc t 
entstanden	  qq ee n t ss t a n d @ n 
entstehen	  qq ee n t ss t e: @ n 
entsteht	  qq ee n t ss t e: t 
entwichen	  qq ee n t v ii cc @ n 
entwickeln	  qq ee n t v ii k @ l n 
entwickelt	  qq ee n t v ii k @ l t 
entwicklung	  qq ee n t v ii k l uu nn 
entwicklungen	  qq ee n t v ii k l uu nn @ n 
entziehen	  qq ee n t t s i: @ n 
entzündungen	  qq ee n t t s yy n d uu nn @ n 
er	  qq ee r 
erbracht	  qq ee r b r a x t 
erbrechen	  qq ee r b r ee cc @ n 
erbringen	  qq ee r b r ii nn @ n 
erdapfel	  qq ee r d a p f @ l 
ereignis	  qq ee r qq ai g n ii s 
erfahren	  qq ee r f aa: r @ n 
erfahrung	  qq ee r f aa: r uu nn 
erfahrungen	  qq ee r f aa: r uu nn @ n 
erfasst	  qq ee r f a s t 
erfinden	  qq ee r f ii n d @ n 
erfolg	  qq ee r f oo l k 
erfolgen	  qq ee r f oo l g @ n 
erfolgreich	  qq ee r f oo l g r ai cc 
erfolgt	  qq ee r f oo l k t 
erfolgte	  qq ee r f oo l g t @ 
erfüllbaren	  qq ee r f yy l b aa: r @ n 
erfüllt	  qq ee r f yy l t 
erfunden	  qq ee r f uu n d @ n 
ergänzen	  qq ee r g ee n t s @ n 
ergebnis	  qq ee r g e: b n ii s 
ergebnisse	  qq ee r g e: b n ii s @ 
ergibt	  qq ee r g i: p t 
erhalten	  qq ee r h a l t @ n 
erhältlich	  qq ee r h ee l t l ii cc 
erheblich	  qq ee r h e: b l ii cc 
erhebliche	  qq ee r h e: b l ii cc @ 
erheblichem	  qq ee r h e: b l ii cc @ m 
erheblichen	  qq ee r h e: b l ii cc @ n 
erheblicher	  qq ee r h e: b l ii cc ei 
erhitzt	  qq ee r h ii t s t 
erhöhen	  qq ee r h ui: @ n 
erhöht	  qq ee r h ui: t 
erholen	  qq ee r h o: l @ n 
erinnern	  qq ee r qq ii n @ r n 
erinnert	  qq ee r qq ii n @ r t 
erkannt	  qq ee r k a n t 
erkennen	  qq ee r k ee n @ n 
erkennt	  qq ee r k ee n t 
erkenntnis	  qq ee r k ee n t n ii s 
erklärt	  qq ee r k l ee r t 
erkundigt	  qq ee r k uu n d ii cc t 
erkundigungen	  qq ee r k uu n d ii g uu nn @ n 
erlangt	  qq ee r l a nn t 
erlassen	  qq ee r l a s @ n 
erläutert	  qq ee r l oy t @ r t 
erlebnisse	  qq ee r l e: p n ii s @ 
erlebt	  qq ee r l e: p t 
erledigt	  qq ee r l e: d ii cc t 
erlernen	  qq ee r l ee r n @ n 
erlitten	  qq ee r l ii t @ n 
ermitteln	  qq ee r m ii t @ l n 
ermittelt	  qq ee r m ii t @ l t 
ernähren	  qq ee r n e: r @ n 
ernährt	  qq ee r n e: r t 
erneuert	  qq ee r n oy @ r t 
erneute	  qq ee r n oy t @ 
ernst	  qq ee r n s t 
ernstes	  qq ee r n s t @ s 
erreger	  qq ee r qq r e: g ei 
erregern	  qq ee r qq r e: g @ r n 
erreichen	  qq ee r qq r ai cc @ n 
erreicht	  qq ee r qq r ai cc t 
erscheint	  qq ee r ss ai n t 
erschüttert	  qq ee r ss yy t @ r t 
ersetzt	  qq ee r z ee t s t 
ersparnisse	  qq ee r ss p a r n ii s @ 
erst	  qq e: r s t 
erstattet	  qq ee r ss t a t @ t 
erste	  qq e: r s t @ 
ersten	  qq e: r s t @ n 
erstklassige	  qq ee r s t k l a s ii g @ 
erstmalig	  qq ee r s t m a l ii cc 
ertrag	  qq ee r t r aa: k 
erträge	  qq ee r t r ee: g @ 
erwärmt	  qq ee r v ee r m t 
erwarten	  qq ee r v a r t @ n 
erwartung	  qq ee r v a r t uu nn 
erwartungen	  qq ee r v a r t uu nn @ n 
erweitern	  qq ee r v ai t @ r n 
erworben	  qq ee r v oo r b @ n 
erwünscht	  qq ee r v yy n ss t 
erzähle	  qq ee r t s e: l @ 
erzählen	  qq ee r t s e: l @ n 
erzählt	  qq ee r t s e: l t 
erziehung	  qq ee r t s i: uu nn 
erzielen	  qq ee r t s i: l @ n 
erzielt	  qq ee r t s i: l t 
es	  qq ee z 
etwa	  qq ee t v aa: 
etwas	  qq ee t v aa: s 
euro	  qq oy r o: 
europa	  qq oy r o: p aa: 
europäische	  qq oy r o: p ee: ii ss @ 
europäischen	  qq oy r o: p ee: ii ss @ n 
exil	  qq ee k s i: l 
existieren	  qq ee k s ii s t i: r @ n 
existiert	  qq ee k s ii s t i: r t 
experiment	  qq ee k s p e: r i: m ee n t 
experte	  qq ee k s p @ r t @ 
experten	  qq ee k s p @ r t @ n 
explodieren	  qq ee k s p l o: d i: r @ n 
explodiert	  qq ee k s p l o: d i: r t 
explosiv	  qq ee k s p l o: z i: f 
export	  qq ee k s p oo r t 
externe	  qq ee k s t @ r n @ 
extrem	  qq ee k s t r e: m 
extreme	  qq ee k s t r e: m @ 
extremes	  qq ee k s t r e: m @ s 
fach	  f a x 
fachbegriffe	  f a x b ee g r ii f @ 
fächern	  f ee cc @ r n 
fahnenstange	  f aa: n @ n s t a nn @ 
fakten	  f a k t @ n 
faktor	  f a k t o: r 
faktoren	  f a k t o: r @ n 
fall	  f a l 
falle	  f a l @ 
fälle	  f ee l @ 
fallen	  f a l @ n 
fällig	  f ee l ii cc 
fallschirm	  f a l ss ii r m 
falsch	  f a l ss 
falsche	  f a l ss @ 
falschen	  f a l ss @ n 
fälschung	  f ee l ss uu nn 
familie	  f a m i: l ii @ 
fand	  f a n t 
fantastisches	  f a n t a s t ii ss @ s 
fass	  f a s 
fässer	  f ee s ei 
fast	  f a s t 
fatal	  f a t aa: l 
fehler	  f e: l ei 
fehlgeschlagen	  f e: l g ee ss l aa: g @ n 
fehlt	  f e: l t 
fern	  f ee r n 
ferner	  f ee r n ei 
fernsehen	  f ee r n z e: @ n 
fernseher	  f ee r n z e: ei 
festgelegt	  f ee s t g @ l e: k t 
festgestellt	  f ee s t g @ ss t ee l t 
fett	  f ee t 
feuer	  f oy ei 
fieber	  f i: b ei 
filiale	  f i: l i: aa: l @ 
finanziell	  f i: n a n t s j ee l 
finanzielle	  f i: n a n t s j ee l @ 
finanziert	  f i: n a n t s i: r t 
finanzsystem	  f i: n a n t s z yy s t @ m 
finden	  f ii n d @ n 
firma	  f ii r m aa: 
firmen	  f ii r m @ n 
fisch	  f ii ss 
fixiert	  f ii k s i: r t 
flasche	  f l a ss @ 
fleisch	  f l ai ss 
fleißig	  f l ai s ii cc 
fliehen	  f l i: @ n 
flucht	  f l uu x t 
flüchten	  f l yy cc t @ n 
flüssigkeit	  f l yy s ii cc k ai t 
folge	  f oo l g @ 
folgen	  f oo l g @ n 
folgenden	  f oo l g @ n d @ n 
folgt	  f oo l k t 
folgte	  f oo l g t @ 
forderung	  f oo r d @ r uu nn 
forderungen	  f oo r d @ r uu nn @ n 
form	  f oo r m 
formuliert	  f oo r m u: l i: r t 
fortsetzen	  f oo r t z ee t s @ n 
frage	  f r aa: g @ 
fragen	  f r aa: g @ n 
frankreich	  f r a nn k r ai cc 
franzose	  f r a n t s o: z @ 
französische	  f r a n t s ui: z ii ss @ 
frau	  f r au 
frauen	  f r au @ n 
freiheit	  f r ai h ai t 
freikaufen	  f r ai k au f @ n 
freiraum	  f r ai r au m 
freiwillig	  f r ai v ii l ii cc 
fremde	  f r ee m d @ 
fremdes	  f r ee m d @ s 
freund	  f r oy n t 
freundlich	  f r oy n d l ii cc 
frieren	  f r i: r @ n 
frisch	  f r ii ss 
frist	  f r ii s t 
froh	  f r o: 
früchte	  f r yy cc t @ 
fruchtfleisch	  f r uu x t f l ai ss 
fruchtsäfte	  f r uu x t z ee f t @ 
fruchtsäften	  f r uu x t z ee f t @ n 
fruchtsafthersteller	  f r uu x t z a f t ei s t ee l ei 
früh	  f r y: 
früher	  f r y: ei 
früheren	  f r y: @ r @ n 
frustration	  f r uu s t r a t s ii o: n 
füge	  f y: g @ 
fühlen	  f y: l @ n 
fühlt	  f y: l t 
führen	  f y: r @ n 
führt	  f y: r t 
fundamente	  f uu n d a m ee n t @ 
fünf	  f yy n f 
fünfunddreißig	  f yy n f uu n d r ai s ii cc 
fünfzehn	  f yy n f t s e: n 
fünfzig	  f yy n f t s ii cc 
fünfzigtausend	  f yy n f t s ii cc t au z @ n t 
funktion	  f uu nn k t s ii o: n 
funktionäre	  f uu nn k t s ii o: n ee: r @ 
funktionieren	  f uu nn k t s ii o: n i: r @ n 
funktioniert	  f uu nn k t s ii o: n i: r t 
für	  f y: r 
furchtbare	  f uu r cc t b aa: r @ 
fürchten	  f yy r cc t @ n 
fürsorglichkeit	  f yy r z oo r g l ii cc k ai t 
fürstlich	  f yy r s t l ii cc 
fusion	  f u: z j o: n 
gab	  g aa: p 
galt	  g a l t 
gängigsten	  g ee nn ii cc s t @ n 
ganz	  g a n t s 
ganze	  g a n t s @ 
ganzen	  g a n t s @ n 
gar	  g aa: r 
garantie	  g a r a n t i: 
garantiert	  g a r a n t i: r t 
gärten	  g ee r t @ n 
gas	  g aa: s 
geahndet	  g @ qq aa: n d @ t 
geändert	  g @ qq ee n d @ r t 
geantwortet	  g @ qq a n t v oo r t @ t 
gearbeitet	  g @ qq a r b ai t @ t 
geäußert	  g @ qq oy s @ r t 
gebaut	  g @ b au t 
geben	  g e: b @ n 
gebeugt	  g @ b oy k t 
gebiete	  g @ b i: t @ 
gebildet	  g @ b ii l d @ t 
geblieben	  g @ b l i: b @ n 
geboten	  g @ b o: t @ n 
gebracht	  g @ b r a x t 
gebrauchen	  g @ b r au x @ n 
gebraucht	  g @ b r au x t 
geburtstag	  g @ b uu r t s t aa: k 
gedacht	  g @ d a x t 
gedanken	  g @ d a nn k @ n 
gedanklich	  g @ d a nn k l ii cc 
gedeckt	  g @ d ee k t 
gedeutet	  g @ d oy t @ t 
gedruckt	  g @ d r uu k t 
gedrückt	  g @ d r yy k t 
geduld	  g @ d uu l t 
geeignet	  g @ qq ai g n @ t 
geendet	  g @ qq ee n d @ t 
geerntet	  g @ qq ee r n t @ t 
gefahr	  g @ f aa: r 
gefährdet	  g @ f e: r d @ t 
gefahren	  g @ f aa: r @ n 
gefährlich	  g @ f e: r l ii cc 
gefährliches	  g @ f e: r l ii cc @ s 
gefallen	  g @ f a l @ n 
gefälscht	  g @ f ee l ss t 
gefängnis	  g @ f ee nn n ii s 
gefeiert	  g @ f ai ei t 
geflügelsalat	  g @ f l y: g @ l z a l aa: t 
gefordert	  g @ f oo r d @ r t 
gefördert	  g @ f ui r d @ r t 
gefühle	  g @ f y: l @ 
geführt	  g @ f y: r t 
gefüllt	  g @ f yy l t 
gefunden	  g @ f uu n d @ n 
gegangen	  g @ g a nn @ n 
gegeben	  g @ g e: b @ n 
gegen	  g e: g @ n 
gegenden	  g e: g @ n t @ n 
gegenstände	  g e: g @ n ss t ee n d @ 
gegenteil	  g e: g @ n t ai l 
gegessen	  g @ g ee s @ n 
geglaubt	  g @ g l au p t 
gegründet	  g @ g r yy n d @ t 
gehalt	  g @ h a l t 
gehalten	  g @ h a l t @ n 
gehandelt	  g @ h a n d @ l t 
gehandhabt	  g @ h a n t h aa: p t 
gehe	  g e: @ 
geheimtipp	  g @ h ai m t ii p 
gehemmt	  g e: ee m t 
gehen	  g e: @ n 
gehofft	  g @ h oo f t 
geholfen	  g @ h oo l f @ n 
gehören	  g @ h ui: r @ n 
gehört	  g @ h ui r t 
gehortet	  g @ h oo r t @ t 
geht	  g e: t 
geist	  g ai s t 
gekauft	  g @ k au f t 
geklagt	  g @ k l aa: k t 
gekommen	  g @ k oo m @ n 
gekostet	  g @ k oo s t @ t 
gekündigt	  g @ k yy n d ii cc t 
gelacht	  g @ l a x t 
gelagert	  g @ l a g @ r t 
gelandet	  g @ l a n d @ t 
gelangen	  g @ l a nn @ n 
gelassen	  g @ l a s @ n 
gelaufen	  g @ l au f @ n 
geld	  g ee l t 
geldes	  g ee l d @ s 
geldmenge	  g ee l d m ee nn @ 
geldmengen	  g ee l d m ee nn @ n 
gelebt	  g @ l e: p t 
gelegenheiten	  g @ l e: g @ n h ai t @ n 
gelegt	  g @ l e: k t 
geleistet	  g @ l ai s t @ t 
gelernt	  g @ l ee r n t 
gelesen	  g @ l e: z @ n 
geliefert	  g @ l i: f @ r t 
gelingen	  g @ l ii nn @ n 
gelitten	  g @ l ii t @ n 
gelohnt	  g @ l o: n t 
gelöst	  g @ l ui s t 
gelten	  g ee l t @ n 
gelüftet	  g @ l yy f t @ t 
gelungen	  g @ l uu nn @ n 
gemacht	  g @ m a x t 
gemeinsam	  g @ m ai n z aa: m 
gemeinsame	  g @ m ai n z aa: m @ 
gemeinschaft	  g @ m ai n ss a f t 
gemeint	  g @ m ai n t 
gemeldet	  g @ m ee l d @ t 
gemessen	  g @ m ee s @ n 
gemüse	  g @ m y: z @ 
genau	  g @ n au 
genaue	  g @ n au @ 
genauso	  g @ n au z o: 
genehmigung	  g @ n e: m ii g uu nn 
generalsekretär	  g e: n ee r a l z ee k r e: t ee: r 
generell	  g e: n e: r ee l 
generiert	  g e: n e: r i: r t 
genießen	  g @ n i: s @ n 
genommen	  g @ n oo m @ n 
genug	  g @ n u: k 
genügen	  g @ n y: g @ n 
genügend	  g @ n y: g @ n t 
geöffnet	  g @ qq ui f n @ t 
geordnet	  g @ qq oo r d n @ t 
gepresster	  g @ p r ee s t ei 
gepumpt	  g @ p uu m p t 
gerade	  g @ qq r aa: d @ 
geradestehen	  g @ qq r a d ee s t e: @ n 
gerät	  g @ r ee: t 
geräte	  g @ r ee: t @ 
geraten	  g @ qq r aa: t @ n 
gerechnet	  g @ qq r ee cc n @ t 
gerecht	  g @ qq r ee cc t 
gerechten	  g @ qq r ee cc t @ n 
gerede	  g @ r e: d @ 
gerettet	  g @ qq r ee t @ t 
gericht	  g @ qq r ii cc t 
gerichte	  g @ qq r ii cc t @ 
gering	  g @ r ii nn 
geringer	  g @ qq r ii nn ei 
geringeren	  g @ qq r ii nn @ r @ n 
geringfügig	  g @ qq r ii nn f y: g ii cc 
gern	  g ee r n 
gerne	  g ee r n @ 
gerüchte	  g @ qq r yy cc t @ 
gerüstet	  g @ qq r yy s t @ t 
gesagt	  g @ z aa: g t 
gesammelt	  g @ z a m @ l t 
gesamte	  g @ z a m t @ 
gesamter	  g @ z a m t ei 
gesang	  g @ z a nn 
gesättigt	  g @ z ee t ii cc t 
geschaffen	  g @ ss a f @ n 
geschafft	  g @ ss a f t 
geschäft	  g @ ss ee f t 
geschäfte	  g @ ss ee f t @ 
geschäftsbedingungen	  g @ ss ee f t s b e: d ii nn uu nn @ n 
geschäftsbeziehungen	  g @ ss ee f t s b e: t s i: uu nn @ n 
geschätzt	  g @ ss ee t s t 
geschaut	  g @ ss au t 
geschehen	  g @ ss e: @ n 
gescheitert	  g @ ss ai t @ r t 
geschenk	  g @ ss ee nn k 
geschenkt	  g @ ss ee nn k t 
geschichte	  g @ ss ii cc t @ 
geschickt	  g @ ss ii k t 
geschickter	  g @ ss ii k t ei 
geschieht	  g @ ss i: t 
geschirrspüler	  g @ ss ii r s p y: l ei 
geschlossen	  g @ ss l oo s @ n 
geschlossenen	  g @ ss l oo s @ n @ n 
geschmack	  g @ ss m a k 
geschnitten	  g @ ss n ii t @ n 
geschrieben	  g @ ss r i: b @ n 
geschützt	  g @ ss yy t s t 
geschweißt	  g @ ss v ai s t 
geschwindigkeit	  g @ ss v ii n d ii cc k ai t 
gesehen	  g @ z e: @ n 
gesellschaft	  g @ z ee l ss a f t 
gesellschaftliche	  g @ z ee l ss a f t l ii cc @ 
gesellschaftlichen	  g @ z ee l ss a f t l ii cc @ n 
gesendet	  g @ z ee n d @ t 
gesenkt	  g @ z ee nn k t 
gesetz	  g @ z ee t s 
gesetze	  g @ z ee t s @ 
gesetzeslage	  g @ z ee t s ee s l aa: g @ 
gesichert	  g @ z ii cc @ r t 
gesorgt	  g @ z oo r k t 
gespeichert	  g @ ss p ai cc @ r t 
gespielt	  g @ ss p i: l t 
gesprochen	  g @ ss p r oo x @ n 
gestartet	  g @ ss t a r t @ t 
gesteigert	  g @ ss t ai g @ r t 
gestellt	  g @ ss t ee l t 
gestern	  g ee s t ei n 
gestiegen	  g @ ss t i: g @ n 
gestimmt	  g @ ss t ii m t 
gestraft	  g @ ss t r a f t 
gestrichen	  g @ ss t r ii cc @ n 
gestritten	  g @ ss t r ii t @ n 
gestürzt	  g @ ss t yy r t s t 
gestützt	  g @ ss t yy t s t 
gesucht	  g @ z u: x t 
gesunde	  g @ z uu n d @ 
gesunken	  g @ z uu nn k @ n 
getan	  g @ t aa: n 
getestet	  g @ t ee s t @ t 
getragen	  g @ t r aa: g @ n 
getreide	  g @ t r ai d @ 
getrieben	  g @ t r i: b @ n 
getroffen	  g @ t r oo f @ n 
getrunken	  g @ t r uu nn k @ n 
gewachsen	  g @ v a k s @ n 
gewählt	  g @ v e: l t 
gewähren	  g @ v e: r @ n 
gewährleistet	  g @ v e: r l ai s t @ t 
gewalt	  g @ v a l t 
gewarnt	  g @ v a r n t 
gewartet	  g @ v a r t @ t 
gewaschen	  g @ v a ss @ n 
gewesen	  g @ v e: z @ n 
gewicht	  g @ v ii cc t 
gewinne	  g @ v ii n @ 
gewinnen	  g @ v i: n @ n 
gewinner	  g @ v ii n ei 
gewinnes	  g @ v ii n @ s 
gewisse	  g @ v ii s @ 
gewissen	  g @ v ii s @ n 
gewissheit	  g @ v ii s h ai t 
gewöhnen	  g @ v ui: n @ n 
gewonnen	  g @ v oo n @ n 
geworden	  g @ v oo r d @ n 
gewünscht	  g @ v yy n ss t 
gewünschte	  g @ v yy n ss t @ 
gewusst	  g @ v uu s t 
gezahlt	  g @ t s aa: l t 
gezählt	  g @ t s e: l t 
gezeigt	  g @ t s ai k t 
gezogen	  g @ t s o: g @ n 
gezwungen	  g @ t s v uu nn @ n 
gibt	  g i: p t 
gift	  g ii f t 
gigantisch	  g i: g a n t ii ss 
gilt	  g ii l t 
glaube	  g l au b @ 
glauben	  g l au b @ n 
gläubiger	  g l oy b ii g ei 
glaubt	  g l au p t 
glaubwürdiger	  g l au b v yy r d ii g ei 
gleich	  g l ai cc 
gleiche	  g l ai cc @ 
gleichen	  g l ai cc @ n 
gleichzeitig	  g l ai cc t s ai t ii cc 
glück	  g l yy k 
glücklich	  g l yy k l ii cc 
glücklicherweise	  g l yy k l ii cc ei v ai z @ 
glücksspiel	  g l yy k s p i: l 
göttingen	  g ui t ii nn @ n 
grad	  g r aa: t 
grafik	  g r a f i: k 
gramm	  g r a m 
gravierenden	  g r a v i: r @ n d @ n 
greifbares	  g r ai f b aa: r @ s 
grenze	  g r ee n t s @ 
grenzen	  g r ee n t s @ n 
griechenland	  g r i: cc @ n l a n t 
groß	  g r o: s 
großbritannien	  g r oo s b r i: t a n ii @ n 
große	  g r o: s @ 
größe	  g r ui: s @ 
großen	  g r o: s @ n 
großer	  g r o: s ei 
größer	  g r ui: s ei 
größere	  g r ui: s @ r @ 
größeren	  g r ui: s @ r @ n 
größeres	  g r ui: s @ r @ s 
großes	  g r o: s @ s 
größte	  g r ui s t @ 
größtenteils	  g r ui s t ee n t ai l s 
grund	  g r uu n t 
grunde	  g r uu n d @ 
gründe	  g r yy n d @ 
grundlagenfach	  g r uu n d l aa: g ee n f a x 
grundlegende	  g r uu n d l e: g @ n d @ 
gründlich	  g r yy n d l ii cc 
grundnahrungsmittel	  g r uu n d n aa: r uu nn s m ii t @ l 
grundsätzlich	  g r uu n d z ee t s l ii cc 
grundsätzliches	  g r uu n d z ee t s l ii cc @ s 
grundversorgung	  g r uu n d v ei z oo r g uu nn 
gruppe	  g r uu p @ 
gruppen	  g r uu p @ n 
gültig	  g yy l t ii cc 
günstig	  g yy n s t ii cc 
günstige	  g yy n s t ii g @ 
günstigste	  g yy n s t ii cc s t @ 
gurken	  g uu r k @ n 
gut	  g u: t 
gute	  g u: t @ 
guten	  g u: t @ n 
guter	  g u: t ei 
güter	  g y: t ei 
gutes	  g u: t @ s 
guthaben	  g uu t h aa: b @ n 
haare	  h aa: r @ 
habe	  h aa: b @ 
haben	  h aa: b @ n 
haften	  h a f t @ n 
haftet	  h a f t @ t 
haftung	  h a f t uu nn 
haken	  h aa: k @ n 
hälfte	  h ee l f t @ 
halle	  h a l @ 
halt	  h a l t 
hält	  h ee l t 
haltbar	  h a l t b aa: r 
haltbare	  h a l t b aa: r @ 
haltbarkeit	  h a l t b a r k ai t 
halte	  h a l t @ 
halten	  h a l t @ n 
handel	  h a n d @ l 
handeln	  h a n d @ l n 
handelsbilanz	  h a n d @ l s b i: l a n t s 
handelt	  h a n d @ l t 
handhabe	  h a n t h aa: b @ 
händler	  h ee n d l ei 
hängt	  h ee nn t 
harmlos	  h a r m l o: s 
harmonische	  h a r m o: n ii ss @ 
hart	  h a r t 
harten	  h a r t @ n 
härtesten	  h ee r t @ s t @ n 
hartnäckig	  h a r t n ee k ii cc 
hast	  h a s t 
hat	  h a t 
hatte	  h a t @ 
hätte	  h ee t @ 
hatten	  h a t @ n 
hätten	  h ee t @ n 
häufig	  h oy f ii cc 
häufigsten	  h oy f ii cc s t @ n 
hauptnahrungsmittel	  h au p t n aa: r uu nn s m ii t @ l 
haus	  h au s 
hause	  h au z @ 
häuser	  h oy z ei 
hauses	  h au z @ s 
haushalt	  h au s h a l t 
haushalte	  h au s h a l t @ 
heiligen	  h ai l ii g @ n 
heißem	  h ai s @ m 
heizen	  h ai t s @ n 
heizung	  h ai t s uu nn 
helfen	  h ee l f @ n 
hell	  h ee l 
heran	  h ee r a n 
herankommen	  h ee r a n k oo m @ n 
heraus	  h ee r au s 
herausfinden	  h ee r au s f ii n d @ n 
herausforderungen	  h ee r au s f oo r d @ r uu nn @ n 
herausgefunden	  h ee r au s g @ f uu n d @ n 
herausgekommen	  h ee r au s g @ k oo m @ n 
herausgesucht	  h ee r au s g @ z u: x t 
herausnehmen	  h ee r au s n e: m @ n 
herbst	  h ee r b s t 
herein	  h ee r ai n 
hergestellt	  h ee r g ee s t ee l t 
herkunft	  h ee r k uu n f t 
herrscher	  h ee r ss ei 
herum	  h ee r uu m 
hervor	  h ee r f oo r 
hervorgehoben	  h ee r f oo r g @ h o: b @ n 
herzlich	  h ee r t s l ii cc 
heterogen	  h e: t e: r o: g @ n 
heute	  h oy t @ 
heutigen	  h oy t ii g @ n 
hier	  h i: r 
hierbei	  h i: r b ai 
hierfür	  h i: r f y: r 
hierzu	  h i: r t s u: 
hilfe	  h ii l f @ 
hilft	  h ii l f t 
hinausgeschoben	  h ii n au s g @ ss o: b @ n 
hinausgeschossen	  h ii n au s g @ ss oo s @ n 
hinausgeworfen	  h ii n au s g @ v oo r f @ n 
hinauslaufen	  h ii n au s l au f @ n 
hinein	  h ii n ai n 
hineinsetzen	  h ii n ai n z ee t s @ n 
hinfahren	  h ii n f aa: r @ n 
hingewiesen	  h ii n g @ v i: z @ n 
hinreichend	  h ii n r ai cc @ n t 
hinreißen	  h ii n r ai s @ n 
hintereinander	  h ii n t ei qq ai n a n d ei 
hintergrund	  h ii n t ei g r uu n t 
hinweise	  h ii n v ai z @ 
hinweisen	  h ii n v ai z @ n 
hinzu	  h ii n t s u: 
hinzugegeben	  h ii n t s u: g @ g e: b @ n 
hinzugekommen	  h ii n t s u: g @ k oo m @ n 
hirse	  h ii r z @ 
historische	  h ii s t o: r ii ss @ 
historischen	  h ii s t o: r ii ss @ n 
hitze	  h ii t s @ 
hoch	  h o: x 
hochschule	  h o: x ss u: l @ 
höchste	  h ui cc s t @ 
höchstwahrscheinlich	  h ui cc s t v aa: r ss ai n l ii cc 
hoffentlich	  h oo f @ n t l ii cc 
hohe	  h o: @ 
höhe	  h ui: @ 
hohen	  h o: @ n 
hoher	  h o: ei 
höher	  h ui: ei 
höhere	  h ui: @ r @ 
höheren	  h ui: @ r @ n 
hohes	  h o: @ s 
holen	  h o: l @ n 
holz	  h oo l t s 
homogen	  h o: m o: g e: n 
horizont	  h o: r i: t s oo n t 
hülsenfrüchten	  h yy l z @ n f r yy cc t @ n 
hundert	  h uu n d @ r t 
husten	  h uu s t @ n 
hygiene	  h y: g i: @ n @ 
hyperinflation	  h ai p @ r ii n f l ee ii ss @ n 
ich	  qq ii cc 
idee	  qq i: d e: 
ideen	  qq i: d e: n 
ignoriert	  qq ii g n o: r i: r t 
ihm	  qq i: m 
ihnen	  qq i: n @ n 
ihr	  qq i: r 
ihre	  qq i: r @ 
ihrem	  qq i: r @ m 
ihren	  qq i: r @ n 
im	  qq ii m 
immensen	  qq ii m ee n z @ n 
immer	  qq ii m ei 
immobilie	  qq ii m o: b i: l ii @ 
immobilien	  qq ii m o: b i: l ii @ n 
immobilienpreise	  qq ii m o: b i: l i: n p r ai z @ 
imperium	  qq ii m p e: r i: uu m 
importiert	  qq ii m p oo r t i: r t 
in	  qq ii n 
index	  qq ii n d ee k s 
indien	  qq ii n d ii @ n 
indirekt	  qq ii n d i: r ee k t 
industrie	  qq ii n d uu s t r i: 
infiziert	  qq ii n f i: t s i: r t 
infizierte	  qq ii n f i: t s i: r t @ 
inflation	  qq ii n f l a t s ii o: n 
inflationsrate	  qq ii n f l a t s ii o: n s r aa: t @ 
informationen	  qq ii n f oo r m a t s ii o: n @ n 
informieren	  qq ii n f oo r m i: r @ n 
informiert	  qq ii n f oo r m i: r t 
infrage	  qq ii n f r aa: g @ 
inhalt	  qq ii n h a l t 
innere	  qq ii n @ r @ 
innerhalb	  qq ii n ei h a l p 
ins	  qq ii n s 
insbesondere	  qq ii n s b e: z oo n d @ r @ 
insekten	  qq ii n z ee k t @ n 
insektizide	  qq ii n z ee k t i: t s i: d @ 
insgesamt	  qq ii n s g e: z a m t 
installation	  qq ii n s t a l a t s ii o: n 
institute	  qq ii n s t i: t u: t @ 
institution	  qq ii n s t i: t u: t s ii o: n 
institutionen	  qq ii n s t i: t u: t s ii o: n @ n 
interessant	  qq ii n t @ r ee s a n t 
interesse	  qq ii n t @ r ee s @ 
interessieren	  qq ii n t @ r ee s i: r @ n 
interessiert	  qq ii n t @ r ee s i: r t 
international	  qq ii n t @ r n a t s ii o: n aa: l 
internationale	  qq ii n t @ r n a t s ii o: n aa: l @ 
interne	  qq ii n t ee r n @ 
internen	  qq ii n t ee r n @ n 
internes	  qq ii n t ee r n @ s 
internet	  qq ii n t ee r n @ t 
investieren	  qq ii n v ee s t i: r @ n 
investiert	  qq ii n v ee s t i: r t 
investition	  qq ii n v ee s t i: t s ii o: n 
inzwischen	  qq ii n t s v ii ss @ n 
irgendetwas	  qq ii r g @ n d ee t v aa: s 
irgendwann	  qq ii r g @ n d v a n 
irgendwie	  qq ii r g @ n d v i: 
isoliert	  qq i: z o: l i: r t 
ist	  qq ii s t 
ja	  j aa: 
jahr	  j aa: r 
jahre	  j aa: r @ 
jahren	  j aa: r @ n 
jahresende	  j aa: r @ s @ n d @ 
jahrhunderten	  j aa: r h uu n d @ r t @ n 
jährlich	  j e: r l ii cc 
jährlichen	  j e: r l ii cc @ n 
jahrzehnten	  j aa: r t s e: n t @ n 
japan	  j a p aa: n 
jede	  j e: d @ 
jeden	  j e: d @ n 
jedenfalls	  j e: d @ n f a l s 
jeder	  j e: d ei 
jederzeit	  j e: d ei t s ai t 
jedes	  j e: d @ s 
jedoch	  j e: d oo x 
jemand	  j e: m a n t 
jemandem	  j e: m a n d @ m 
jetzt	  j ee t s t 
jeweils	  j e: v ai l s 
jugendlichen	  j u: g @ n d l ii cc @ n 
jugoslawien	  j u: g oo s l a v ii @ n 
kaffee	  k a f e: 
kalifornien	  k a l i: f oo r n ii @ n 
kalorien	  k a l o: r i: @ n 
kam	  k aa: m 
kampagne	  k a m p a g n @ 
kampf	  k a m p f 
kämpfen	  k ee m p f @ n 
kanada	  k a n a d aa: 
kanälen	  k a n ee: l @ n 
kandidat	  k a n d i: d aa: t 
kann	  k a n 
kapital	  k a p i: t aa: l 
kapitalflucht	  k a p i: t a l f l uu x t 
kaputtgegangen	  k a p uu t g e: g a nn @ n 
karneval	  k a r n e: v aa: l 
karriere	  k a r i: r @ 
karte	  k a r t @ 
kartell	  k a r t ee l 
kartelle	  k a r t ee l @ 
kartoffeln	  k a r t oo f @ l n 
kartoffelsalat	  k a r t oo f ee l z a l aa: t 
käse	  k ee: z @ 
kasse	  k a s @ 
katastrophe	  k a t a s t r oo f @ 
katastrophen	  k a t a s t r oo f @ n 
kauf	  k au f 
kaufempfehlung	  k au f ee m p f e: l uu nn 
kaufen	  k au f @ n 
kaufkraft	  k au f k r a f t 
kauft	  k au f t 
kaum	  k au m 
kehren	  k e: r @ n 
kehrt	  k e: r t 
keime	  k ai m @ 
kein	  k ai n 
keine	  k ai n @ 
keinem	  k ai n @ m 
keinen	  k ai n @ n 
keiner	  k ai n ei 
keineswegs	  k ai n ee s v e: g s 
keller	  k ee l ei 
kennen	  k ee n @ n 
kennt	  k ee n t 
kernaufgaben	  k ee r n au f g aa: b @ n 
kerzen	  k ee r t s @ n 
ketten	  k ee t @ n 
kilogramm	  k i: l oo g r a m 
kilometer	  k i: l o: m e: t ei 
kind	  k ii n t 
kinder	  k ii n d ei 
kindern	  k ii n d @ r n 
kindeswohl	  k ii n d ee s v o: l 
kissen	  k ii s @ n 
klappen	  k l a p @ n 
klar	  k l aa: r 
klare	  k l aa: r @ 
klären	  k l ee: r @ n 
klarer	  k l aa: r ei 
klassen	  k l a s @ n 
klausel	  k l au z @ l 
kleidung	  k l ai d uu nn 
klein	  k l ai n 
kleine	  k l ai n @ 
kleinen	  k l ai n @ n 
kleiner	  k l ai n ei 
kleinsten	  k l ai n s t @ n 
klick	  k l ii k 
klicken	  k l ii k @ n 
klingt	  k l ii nn t 
klug	  k l u: k 
knapp	  k n a p 
knappheit	  k n a p f ai t 
knoten	  k n o: t @ n 
kochen	  k oo x @ n 
kohle	  k o: l @ 
kohlendioxid	  k o: l @ n d ii o: k s i: t 
kohlenhydrate	  k o: l @ n h yy d r aa: t @ 
kollabieren	  k oo l a b i: r @ n 
kollabiert	  k oo l a b i: r t 
kollaps	  k oo l aa: p s 
kollegen	  k oo l e: g @ n 
kolonien	  k o: l o: n ii @ n 
komma	  k oo m aa: 
kommen	  k oo m @ n 
kommenden	  k oo m @ n d @ n 
kommentar	  k oo m ee n t aa: r 
kommentare	  k oo m ee n t aa: r @ 
kommt	  k oo m t 
komplettes	  k oo m p l ee t @ s 
komplexität	  k oo m p l ee k s i: t ee: t 
komplizierter	  k oo m p l i: t s i: r t ei 
kompromiss	  k oo m p r o: m ii s 
konjunktur	  k oo n j uu nn k t u: r 
konkrete	  k oo nn k r e: t @ 
konkurrenz	  k oo n k uu r ee n t s 
konkurs	  k oo n k u: r s 
konkurse	  k oo n k uu r z @ 
können	  k ui n @ n 
konnte	  k oo n t @ 
könnte	  k ui n t @ 
konnten	  k oo n t @ n 
könnten	  k ui n t @ n 
konsequenter	  k oo n z e: k v ee n t ei 
konsequenzen	  k oo n z e: k v ee n t s @ n 
konservative	  k oo n z ee r v a t i: v @ 
konserven	  k oo n z ee r v @ n 
konstrukte	  k oo n s t r uu k t @ 
konsum	  k oo n z uu m 
konsumenten	  k oo n z u: m ee n t @ n 
konsumiert	  k oo n z u: m i: r t 
kontakte	  k oo n t a k t @ 
konto	  k oo n t o: 
kontraproduktiv	  k oo n t r a p r o: d uu k t i: f 
kontrast	  k oo n t r a s t 
kontrolle	  k oo n t r oo l @ 
kontrollen	  k oo n t r oo l @ n 
kontrollieren	  k oo n t r oo l i: r @ n 
konzentrate	  k oo n t s ee n t r aa: t @ 
konzentration	  k oo n t s ee n t r a t s ii o: n 
konzentriert	  k oo n t s ee n t r i: r t 
konzern	  k oo n t s ei n 
konzerne	  k oo n t s ei n e: 
kopf	  k oo p f 
kopfsalat	  k oo p f z a l aa: t 
korb	  k oo r p 
korrektur	  k oo r ee k t u: r 
korrekturen	  k oo r ee k t u: r @ n 
kosten	  k oo s t @ n 
kostenfrei	  k oo s t @ n f r ai 
kostenlos	  k oo s t @ n l o: s 
kostenlose	  k oo s t @ n l o: z @ 
kostet	  k oo s t @ t 
kracht	  k r a x t 
krankenhäuser	  k r a n k @ n h oy z ei 
kredit	  k r e: d ii t 
kredite	  k r e: d i: t @ 
krediten	  k r e: d i: t @ n 
kreises	  k r ai z @ s 
kreislauf	  k r ai s l au f 
kreislaufstörungen	  k r ai s l au f s t ui: r uu nn @ n 
krieg	  k r i: k 
kriege	  k r i: g @ 
kriegen	  k r i: g @ n 
krise	  k r ii s @ 
krisen	  k r ii s @ n 
kriterium	  k r i: t e: r i: uu m 
kritik	  k r i: t i: k 
kritisch	  k r i: t ii ss 
kritisiert	  k r i: t i: z i: r t 
küche	  k yy cc @ 
küchen	  k yy cc @ n 
kühe	  k y: @ 
kühl	  k y: l 
kühlbox	  k y: l b oo k s 
kühlschrank	  k y: l ss r a nn k 
kulturen	  k uu l t u: r @ n 
kümmern	  k yy m @ r n 
kümmert	  k yy m @ r t 
kunden	  k uu n d @ n 
kündigung	  k yy n d ii g uu nn 
kunst	  k u: n s t 
künstlich	  k yy n s t l ii cc 
kunststoff	  k uu n s t s t oo f 
kurs	  k u: r s 
kurse	  k uu r z @ 
kurz	  k uu r t s 
kurze	  k uu r t s @ 
kurzem	  k uu r t s @ m 
kurzen	  k uu r t s @ n 
kurzer	  k uu r t s ei 
kürzere	  k yy r t s @ r @ 
kurzfristig	  k uu r t s f r ii s t ii cc 
lage	  l aa: g @ 
lagern	  l a g @ r n 
lagerzeit	  l a g ei t s ai t 
land	  l a n t 
landen	  l a n d @ n 
länder	  l ee n d ei 
ländern	  l ee n d @ r n 
landet	  l a n d @ t 
lange	  l a nn @ 
langem	  l a nn @ m 
langer	  l a nn ei 
länger	  l ee nn ei 
längere	  l ee nn @ r @ 
längerer	  l ee nn @ r ei 
langeweile	  l a nn e: v ai l @ 
langfristige	  l a nn f r ii s t ii g @ 
langsam	  l a nn z aa: m 
langsamer	  l a nn z aa: m ei 
langweilige	  l a nn v ai l ii g @ 
langweiliges	  l a nn v ai l ii g @ s 
lärm	  l ee r m 
lassen	  l a s @ n 
lässt	  l ee s t 
last	  l a s t 
lästig	  l ee s t ii cc 
lauf	  l au f 
laufen	  l au f @ n 
läuft	  l oy f t 
laufwerk	  l au f v ee r k 
laut	  l au t 
leben	  l e: b @ n 
lebensmittel	  l e: b @ n s m ii t @ l 
lebensmittelindustrie	  l e: b @ n s m ii t @ l ii n d uu s t r i: 
lebensmittelpackungen	  l e: b @ n s m ii t @ l p a k uu nn @ n 
lebensunterhalt	  l e: b @ n z uu n t ei h a l t 
lebenszeit	  l e: b @ n s t s ai t 
leber	  l e: b ei 
lebt	  l e: p t 
lebten	  l e: p t @ n 
lediglich	  l e: d ii g l ii cc 
leer	  l e: r 
legendären	  l e: g @ n d ee: r @ n 
legitimiert	  l e: g i: t i: m i: r t 
legitimität	  l e: g i: t i: m i: t ee: t 
leicht	  l ai cc t 
leid	  l ai t 
leider	  l ai d ei 
leidet	  l ai d @ t 
leise	  l ai z @ 
leisten	  l ai s t @ n 
leistung	  l ai s t uu nn 
leistungen	  l ai s t uu nn @ n 
leitbild	  l ai t b ii l t 
lernen	  l ee r n @ n 
lesen	  l e: z @ n 
lesenswert	  l e: z @ n s v ee r t 
lesern	  l e: z @ r n 
letzten	  l ee t s t @ n 
letztlich	  l ee t s t l ii cc 
leute	  l oy t @ 
leuten	  l oy t @ n 
lieber	  l i: b ei 
lieferzeiten	  l i: f ei t s ai t @ n 
liegen	  l i: g @ n 
liegestuhl	  l i: g ee s t u: l 
liegt	  l i: k t 
linie	  l i: n ii @ 
linsen	  l ii n z @ n 
liste	  l ii s t @ 
listen	  l ii s t @ n 
liter	  l i: t ei 
lohn	  l o: n 
löhne	  l ui: n @ 
lohnen	  l o: n @ n 
lokale	  l o: k aa: l @ 
london	  l oo n d o: n 
los	  l o: s 
lösen	  l ui: z @ n 
losgehen	  l oo s g e: @ n 
lösung	  l ui: z uu nn 
lotto	  l oo t o: 
luft	  l uu f t 
luxemburg	  l uu k s ee m b uu r k 
machen	  m a x @ n 
macht	  m a x t 
mächtige	  m ee cc t ii g @ 
mag	  m aa: k 
mähdrescher	  m e: d r ee ss ei 
mahlzeit	  m aa: l t s ai t 
mahnwachen	  m aa: n v a x @ n 
mais	  m ai s 
mal	  m aa: l 
man	  m a n 
manager	  m a n aa: g ei 
manche	  m a n cc @ 
mangelndes	  m a nn n t @ s 
manipulationen	  m a n i: p u: l a t s ii o: n @ n 
manipulieren	  m a n i: p u: l i: r @ n 
manipuliert	  m a n i: p u: l i: r t 
mann	  m a n 
männern	  m ee n @ r n 
mappe	  m a p @ 
markt	  m a r k t 
marktanteile	  m a r k t a n t ai l @ 
märkte	  m ee r k t @ 
marktes	  m a r k t @ s 
marmeladen	  m a r m @ l aa: d @ n 
maschinen	  m a ss ii n @ n 
masse	  m a s @ 
massenhaftes	  m a s @ n h a f t @ s 
massiv	  m a s i: f 
massive	  m a s i: v @ 
massivem	  m a s i: v @ m 
massiven	  m a s i: v @ n 
material	  m a t e: r i: aa: l 
materialien	  m a t e: r i: a l ii @ n 
mathematik	  m a t h e: m a t i: k 
mäusen	  m oy z @ n 
maximale	  m a k s i: m aa: l @ 
mechanismen	  m ee cc a n ii s m @ n 
medien	  m e: d ii @ n 
medikamente	  m e: d i: k a m ee n t @ 
medizinische	  m e: d i: t s i: n ii ss @ 
meer	  m e: r 
mehlkäfer	  m e: l k ee: f ei 
mehr	  m e: r 
mehrere	  m e: r @ r @ 
mehreren	  m e: r @ r @ n 
mehrheit	  m e: r h ai t 
mehrwertsteuer	  m e: r v ei t s t oy ei 
mein	  m ai n 
meine	  m ai n @ 
meiner	  m ai n ei 
meinung	  m ai n uu nn 
meinungen	  m ai n uu nn @ n 
meinungsumfragen	  m ai n uu nn s qq uu m f r aa: g @ n 
meisten	  m ai s t @ n 
meistens	  m ai s t @ n s 
meldung	  m ee l d uu nn 
meldungen	  m ee l d uu nn @ n 
menge	  m ee nn @ 
mengen	  m ee nn @ n 
mensch	  m ee n ss 
menschen	  m ee n ss @ n 
merken	  m ee r k @ n 
merkwürdiges	  m ee r k v yy r d ii g @ s 
methode	  m e: t o: d @ 
methoden	  m e: t o: d @ n 
mexiko	  m ee k s i: k o: 
mich	  m ii cc 
mieten	  m i: t @ n 
mieter	  m i: t ei 
mietern	  m i: t @ r n 
mikrofon	  m i: k r o: f o: n 
mikrofone	  m i: k r o: f o: n @ 
mikrowelle	  m i: k r o: v ee l @ 
milben	  m ii l b @ n 
milch	  m ii l cc 
militärische	  m i: l i: t ee: r ii ss @ 
milliarden	  m ii l i: a r d @ n 
million	  m ii l j o: n 
millionen	  m ii l j o: n @ n 
mindestlohn	  m ii n d ee s t l o: n 
mindestmaß	  m ii n d ee s t m aa: s 
mineralwasser	  m i: n e: r a l v a s ei 
minimiert	  m i: n i: m i: r t 
ministerium	  m i: n ii s t e: r i: uu m 
minuten	  m i: n u: t @ n 
mir	  m i: r 
misstrauen	  m ii s ss t r au @ n 
mit	  m ii t 
mitarbeiter	  m ii t qq a r b ai t ei 
miteinander	  m ii t qq ai n a n d ei 
mitgerissen	  m ii t g @ qq r ii s @ n 
mitgespielt	  m ii t g @ ss p i: l t 
mitgeteilt	  m ii t g @ t ai l t 
mitglieder	  m ii t g l i: d ei 
mithalten	  m ii t h a l t @ n 
mitmachen	  m ii t m a x @ n 
mitreden	  m ii t r e: d @ n 
mitteilung	  m ii t t ai l uu nn 
mittel	  m ii t @ l 
mittelalter	  m ii t @ l a l t ei 
mittelbar	  m ii t @ l b aa: r 
mittlere	  m ii t l @ r @ 
mittlerweile	  m ii t l ei v ai l @ 
möchte	  m ui cc t @ 
möchten	  m ui cc t @ n 
modell	  m o: d ee l 
modelle	  m o: d ee l @ 
moderne	  m o: d ee r n @ 
möglich	  m ui: g l ii cc 
mögliche	  m ui: g l ii cc @ 
möglichen	  m ui: g l ii cc @ n 
möglicher	  m ui: g l ii cc ei 
möglicherweise	  m ui g l ii cc ei v ai z @ 
möglichkeit	  m ui: g l ii cc k ai t 
möglichkeiten	  m ui g l ii cc k ai t @ n 
möglichst	  m ui g l ii cc s t 
moment	  m o: m ee n t 
momentan	  m o: m @ n t aa: n 
monat	  m o: n aa: t 
monate	  m o: n aa: t @ 
monaten	  m o: n aa: t @ n 
monatslohn	  m o: n a t s l o: n 
montag	  m o: n t aa: k 
moralisch	  m o: r a l ii ss 
morgen	  m oo r g @ n 
motorräder	  m o: t o: r r ee: d ei 
mühe	  m y: @ 
muss	  m uu s 
müssen	  m yy s @ n 
musste	  m uu s t @ 
müsste	  m yy s t @ 
mussten	  m uu s t @ n 
müssten	  m yy s t @ n 
mutter	  m uu t ei 
nach	  n a x 
nachahmer	  n a x aa: m ei 
nachbarn	  n a x b a r n 
nachdenklich	  n a x d @ nn k l ii cc 
nachfolgende	  n a x f oo l g @ n d @ 
nachfrage	  n a x f r aa: g @ 
nachgefragt	  n a x g ee f r aa: k t 
nachgeholt	  n a x g e: oo l t 
nachgerechnet	  n a x g e: r ee cc n @ t 
nachgeschlagen	  n a x g ee ss l aa: g @ n 
nachgewiesen	  n a x g e: v i: z @ n 
nachkommen	  n a x k oo m @ n 
nachprüfen	  n a x p r y: f @ n 
nachricht	  n a x r ii cc t 
nachrichten	  n a x r ii cc t @ n 
nachschub	  n a x ss u: p 
nachschusspflicht	  n a x ss uu s p f l ii cc t 
nachsehen	  n a x z e: @ n 
nächste	  n ee cc s t @ 
nächstes	  n ee cc s t @ s 
nacht	  n a x t 
nachteil	  n a x t ai l 
nachteile	  n a x t ai l @ 
nachtschattengewächse	  n a x t ss a t ee n g e: v ee k s @ 
nachvollziehbar	  n a x f oo l t s i: b aa: r 
nachziehen	  n a x t s i: @ n 
nägel	  n ee: g @ l 
näher	  n e: ei 
nährstoffe	  n e: r s t oo f @ 
nahrung	  n aa: r uu nn 
nahrungsmittel	  n aa: r uu nn s m ii t @ l 
nahrungsmitteln	  n aa: r uu nn s m ii t @ l n 
name	  n aa: m @ 
namen	  n aa: m @ n 
national	  n a t s ii o: n aa: l 
nationale	  n a t s ii o: n aa: l @ 
natur	  n a t u: r 
natürlich	  n a t y: r l ii cc 
natürliche	  n a t y: r l ii cc @ 
neben	  n e: b @ n 
negativ	  n e: g a t i: f 
negative	  n e: g a t i: v @ 
nehmen	  n e: m @ n 
nennenswerten	  n ee n @ n s v ee r t @ n 
nerven	  n ee r v @ n 
nervös	  n ee r v ui: s 
nervt	  n ee r v t 
nett	  n ee t 
netz	  n ee t s 
neu	  n oy 
neue	  n oy @ 
neuen	  n oy @ n 
neues	  n oy @ s 
neugierig	  n oy g i: r ii cc 
neuigkeiten	  n oy ii cc k ai t @ n 
neun	  n oy n 
neunhundert	  n oy n h uu n d @ r t 
neunzehnhundertachtzig	  n oy n t s e: n h uu n d ei t a x t s ii cc 
neunzehnhundertdreiundzwanzig	  n oy n t s e: n h uu n d ei t d r ai uu n d t s v a n t s ii cc 
neunzehnhunderteinundneunzig	  n oy n t s e: n h uu n d ei t ai n uu n d n oy n t s ii cc 
neunzehnhundertneunundachtzig	  n oy n t s e: n h uu n d ei t n oy n uu n d a x t s ii cc 
neunzehnhundertvierundachtzig	  n oy n t s e: n h uu n d ei t v i: r uu n d a x t s ii cc 
neunzehnhundertzweiundneunzig	  n oy n t s e: n h uu n d ei t s v ai uu n d n oy n t s ii cc 
neutral	  n oy t r aa: l 
nicht	  n ii cc t 
nichts	  n ii cc t s 
nie	  n i: 
niedergang	  n i: d ei g a nn 
niederschlagen	  n i: d ei ss l aa: g @ n 
niedrig	  n i: d r ii cc 
niedrige	  n i: d r ii g @ 
niedrigen	  n i: d r ii g @ n 
niedriger	  n i: d r ii g ei 
niedrigeres	  n i: d r ii g @ r @ s 
niedriges	  n i: d r ii g @ s 
niemals	  n i: m aa: l s 
niemand	  n i: m a n t 
niemandem	  n i: m a n d @ m 
nimmt	  n ii m t 
niveau	  n i: v e: au 
noch	  n oo x 
nominale	  n o: m i: n aa: l @ 
nordafrika	  n oo r d a f r i: k aa: 
normal	  n oo r m aa: l 
normalerweise	  n oo r m a l ei v ai z @ 
normales	  n oo r m aa: l @ s 
normalisierung	  n oo r m a l i: z i: r uu nn 
notiert	  n o: t i: r t 
nötige	  n ui: t ii g @ 
notizen	  n o: t i: t s @ n 
notwendig	  n oo t v @ n d ii cc 
notwendige	  n oo t v @ n d ii g @ 
null	  n uu l 
nun	  n u: n 
nur	  n u: r 
nützliche	  n yy t s l ii cc @ 
nutzpflanze	  n uu t s p f l a n t s @ 
nutzung	  n uu t s uu nn 
oben	  qq o: b @ n 
obrigkeit	  qq oo p r ii cc k ai t 
obst	  qq o: b s t 
oder	  qq o: d ei 
offen	  qq oo f @ n 
offenbar	  qq oo f @ n b aa: r 
offensichtlich	  qq oo f ee n z ii cc t l ii cc 
öffentlich	  qq ui f @ n t l ii cc 
öffentliche	  qq ui f @ n t l ii cc @ 
Öffentlichkeit	  qq ui f @ n t l ii cc k ai t 
offizielle	  qq oo f i: t s j ee l @ 
offiziellen	  qq oo f i: t s j ee l @ n 
Öffnen	  qq ui f n @ n 
oft	  qq oo f t 
ohne	  qq o: n @ 
ohrring	  o uu r ii nn 
Öl	  qq ui: l 
operativ	  qq o: p e: r a t i: f 
operieren	  qq o: p e: r i: r @ n 
optimiert	  qq oo p t i: m i: r t 
option	  qq oo p t s ii o: n 
optionen	  qq oo p t s ii o: n @ n 
organisation	  qq oo r g a n i: z a t s ii o: n 
organisiert	  qq oo r g a n i: z i: r t 
orientiert	  qq o: r ii ee n t i: r t 
original	  qq o: r i: g i: n aa: l 
ort	  qq oo r t 
ostblock	  qq oo s t b l oo k 
ostblocks	  qq oo s t b l oo k s 
osteuropa	  qq oo s t oy r o: p aa: 
paar	  p aa: r 
packungen	  p a k uu nn @ n 
paket	  p aa: k @ t 
palette	  p a l ee t @ 
panik	  p a n i: k 
papier	  p a p i: r 
papiere	  p a p i: r @ 
papiertiger	  p a p i: r t ii g ei 
partner	  p a r t n ei 
passieren	  p a s i: r @ n 
passiert	  p a s i: r t 
passwort	  p a s v oo r t 
patienten	  p a t s ii ee n t @ n 
pause	  p au z @ 
pendelt	  p ee n d @ l t 
perfekt	  p ee r f ee k t 
person	  p ee r z o: n 
personal	  p ee r z o: n aa: l 
personen	  p ee r z o: n @ n 
persönlich	  p ee r z ui: n l ii cc 
persönliche	  p ee r z ui: n l ii cc @ 
persönlichen	  p ee r z ui: n l ii cc @ n 
persönlicher	  p ee r z ui: n l ii cc ei 
perspektiven	  p ee r s p ee k t i: v @ n 
pflanze	  p f l a n t s @ 
pflicht	  p f l ii cc t 
phänomen	  f ee: n o: m @ n 
physikalische	  f y: z i: k a l ii ss @ 
physisch	  f y: z ii ss 
plan	  p l aa: n 
plant	  p l a n t 
plastikdosen	  p l a s t ii k d o: z @ n 
platzen	  p l a t s @ n 
plausibel	  p l au z i: b @ l 
pleite	  p l ai t @ 
plötzlich	  p l ui t s l ii cc 
politik	  p o: l i: t i: k 
politiker	  p o: l i: t i: k ei 
politischen	  p o: l i: t ii ss @ n 
portion	  p oo r t s ii o: n 
positiv	  p o: z i: t i: f 
positive	  p o: z i: t i: v @ 
posten	  p oo s t @ n 
potenzial	  p o: t @ n t s i: aa: l 
praktisch	  p r a k t ii ss 
prämie	  p r ee: m ii @ 
präsentiert	  p r ee: z @ n t i: r t 
präsident	  p r ee: z i: d ee n t 
präsidenten	  p r ee: z i: d ee n t @ n 
praxis	  p r a k s ii s 
preis	  p r ai s 
preise	  p r ai z @ 
preisen	  p r ai z @ n 
preisgünstiger	  p r ai s g yy n s t ii g ei 
preisniveau	  p r ai s n i: v e: au 
preisstabilität	  p r ai s ss t a b i: l i: t ee: t 
preissteigerungen	  p r ai s ss t ai g @ r uu nn @ n 
presse	  p r ee s @ 
primäre	  p r i: m ee: r @ 
privatanleger	  p r i: v aa: t qq a n l e: g ei 
private	  p r i: v aa: t @ 
privathaushalte	  p r i: v aa: t h au s h a l t @ 
privatkonkurs	  p r i: v aa: t k oo n k u: r s 
privilegierten	  p r i: v i: l e: g i: r t @ n 
pro	  p r o: 
probezeit	  p r o: b e: t s ai t 
problem	  p r o: b l e: m 
probleme	  p r o: b l e: m @ 
problemlos	  p r o: b l e: m l o: s 
produkt	  p r o: d uu k t 
produkte	  p r o: d uu k t @ 
produktion	  p r o: d uu k t s ii o: n 
produktive	  p r o: d uu k t i: v @ 
produktivität	  p r o: d uu k t i: v i: t ee: t 
produzenten	  p r o: d u: t s ee n t @ n 
produzieren	  p r o: d u: t s i: r @ n 
produziert	  p r o: d u: t s i: r t 
professor	  p r o: f ee s o: r 
profitabler	  p r o: f i: t aa: b l ei 
profitieren	  p r o: f i: t i: r @ n 
prognose	  p r o: g n o: z @ 
prognosen	  p r o: g n o: z @ n 
prognostiziert	  p r o: g n oo s t i: t s i: r t 
programm	  p r o: g r a m 
programme	  p r o: g r a m @ 
prominenten	  p r o: m i: n ee n t @ n 
promotion	  p r o: m o: t s ii o: n 
propaganda	  p r o: p a g a n d aa: 
protest	  p r o: t @ s t 
proteste	  p r o: t @ s t @ 
provisionen	  p r o: v i: z j o: n @ n 
provoziert	  p r o: v o: t s i: r t 
prozent	  p r o: t s ee n t 
prozess	  p r o: t s ee s 
prüfen	  p r y: f @ n 
psychologie	  p s y: cc o: l o: g i: 
psychologischen	  p s y: cc o: l o: g ii ss @ n 
quadratur	  k v a d r a t u: r 
qualität	  k v aa: l i: t ee: t 
quartal	  k v a r t aa: l 
quelle	  k v ee l @ 
quellen	  k v ee l @ n 
quote	  k v o: t @ 
rabatte	  qq r a b a t @ 
radio	  qq r a d ii o: 
rasant	  qq r a z a n t 
raten	  qq r aa: t @ n 
rathäuser	  qq r a t h oy z ei 
rationiert	  qq r a t s ii o: n i: r t 
ratschläge	  qq r a t ss l ee: g @ 
ratten	  qq r a t @ n 
raum	  qq r au m 
rausch	  qq r au ss 
rausfliegen	  qq r au s f l i: g @ n 
reagieren	  qq r e: a g i: r @ n 
real	  qq r e: aa: l 
reale	  qq r e: aa: l @ 
realen	  qq r e: aa: l @ n 
realisieren	  qq r e: a l i: z i: r @ n 
realistische	  qq r e: a l ii s t ii ss @ 
realität	  qq r e: aa: l i: t ee: t 
rechenschaft	  qq r ee cc @ n ss a f t 
rechnen	  qq r ee cc n @ n 
rechnet	  qq r ee cc n @ t 
rechnung	  qq r ee cc n uu nn 
rechnungen	  qq r ee cc n uu nn @ n 
recht	  qq r ee cc t 
rechteckig	  qq r ee cc t ee k ii cc 
rechts	  qq r ee cc t s 
rechtsstaat	  qq r ee cc t s ss t aa: t 
rechtzeitig	  qq r ee cc t s ai t ii cc 
reden	  r e: d @ n 
reduziert	  r e: d u: t s i: r t 
reform	  qq r e: f oo r m 
reformiert	  qq r e: f oo r m i: r t 
regale	  qq r e: g aa: l @ 
regel	  qq r e: g @ l 
regelmäßig	  qq r e: g @ l m ee: s ii cc 
regelmäßige	  qq r e: g @ l m ee: s ii g @ 
regeln	  qq r e: g @ l n 
regelungen	  qq r e: g @ l uu nn @ n 
regierung	  qq r e: g i: r uu nn 
regierungswechsel	  qq r e: g i: r uu nn s v ee cc z @ l 
region	  qq r e: g j o: n 
regionalen	  qq r e: g ii o: n aa: l @ n 
regionalisierung	  qq r e: g ii o: n a l i: z i: r uu nn 
reich	  qq r ai cc 
reihe	  qq r ai h @ 
reinigen	  qq r ai n ii g @ n 
reinigung	  qq r ai n ii g uu nn 
reis	  qq r ai s 
reisen	  qq r ai z @ n 
relativ	  qq r e: l a t i: f 
rendite	  qq r ee n d i: t @ 
renditen	  qq r ee n d i: t @ n 
rente	  qq r ee n t @ 
rentenversicherung	  qq r ee n t @ n f ee r z ii cc @ r uu nn 
rentner	  qq r ee n t n ei 
repariert	  qq r e: p a r i: r t 
republikaner	  qq r e: p u: b l i: k aa: n ei 
reserven	  qq r e: z @ r v @ n 
respekt	  qq r ee s p ee k t 
respektvoll	  qq r ee s p ee k t f oo l 
rest	  qq r ee s t 
restlichen	  qq r ee s t l ii cc @ n 
retten	  qq r ee t @ n 
rettung	  qq r ee t uu nn 
rettungsanker	  qq r ee t uu nn s qq a nn k ei 
revolution	  qq r e: v o: l u: t s ii o: n 
rezession	  qq r e: t s ee s j o: n 
richtig	  qq r ii cc t ii cc 
richtige	  qq r ii cc t ii g @ 
richtigen	  qq r ii cc t ii g @ n 
riegel	  qq r i: g @ l 
riesig	  qq r i: z ii cc 
riesige	  qq r i: z ii g @ 
riesiges	  qq r i: z ii g @ s 
risiken	  qq r i: z i: k @ n 
risiko	  qq r i: z i: k o: 
riskant	  qq r ii s k a n t 
riskieren	  qq r ii s k i: r @ n 
roggen	  qq r oo g @ n 
rohstoff	  qq r o: s t oo f 
rohstoffe	  qq r o: s t oo f @ 
rolle	  qq r oo l @ 
rollen	  qq r oo l @ n 
rom	  qq r o: m 
rücken	  qq r yy k @ n 
rücklagen	  qq r yy k l aa: g @ n 
rückmeldung	  qq r yy k m @ l d uu nn 
rücksicht	  qq r yy k s ii cc t 
rückt	  qq r yy k t 
ruhe	  qq r u: @ 
ruhig	  qq r u: ii cc 
ruhiges	  qq r u: ii g @ s 
ruiniert	  qq r u: i: n i: r t 
rumänien	  qq r u: m ee: n ii @ n 
rund	  qq r uu n t 
runde	  qq r uu n d @ 
rundherum	  qq r uu n t h e: r uu m 
russland	  qq r uu s l a n t 
rutschen	  qq r uu t ss @ n 
sache	  z a x @ 
sachverhalt	  z a x v ei h a l t 
saft	  z a f t 
sagen	  z aa: g @ n 
sagt	  z aa: g t 
sanktionen	  z a nn k t s ii o: n @ n 
satire	  z a t i: r @ 
satzzeichen	  z a t s ai cc @ n 
sauber	  z au b ei 
schaden	  ss aa: d @ n 
schäden	  ss ee: d @ n 
schädlinge	  ss ee d l ii nn @ 
schädlingen	  ss ee d l ii nn @ n 
schaffen	  ss a f @ n 
schalter	  ss a l t ei 
schatz	  ss a t s 
schätzungen	  ss ee t s uu nn @ n 
schauen	  ss au @ n 
scheidung	  ss ai d uu nn 
scheidungen	  ss ai d uu nn @ n 
scheinbar	  ss ai n b aa: r 
scheine	  ss ai n @ 
scheinen	  ss ai n @ n 
scheint	  ss ai n t 
scheitern	  ss ai t @ r n 
scheitert	  ss ai t @ r t 
schicht	  ss ii cc t 
schicksal	  ss ii k z aa: l 
schief	  ss i: f 
schieflage	  ss i: f l aa: g @ 
schlagartig	  ss l a g a r t ii cc 
schlange	  ss l a nn @ 
schlecht	  ss l ee cc t 
schlechte	  ss l ee cc t @ 
schlechten	  ss l ee cc t @ n 
schlechter	  ss l ee cc t ei 
schlechtere	  ss l ee cc t @ r @ 
schlechtes	  ss l ee cc t @ s 
schleppend	  ss l ee p @ n t 
schließen	  ss l i: s @ n 
schließenden	  ss l i: s @ n d @ n 
schlimme	  ss l ii m @ 
schlimmer	  ss l ii m ei 
schlimmes	  ss l ii m @ s 
schlimmsten	  ss l ii m s t @ n 
schluss	  ss l uu s 
schlussfolgerung	  ss l uu s f oo l g @ r uu nn 
schmeckt	  ss m ee k t 
schneiden	  ss n ai d @ n 
schneider	  ss n ai d ei 
schnell	  ss n ee l 
schneller	  ss n ee l ei 
schnellsten	  ss n ee l s t @ n 
schock	  ss oo k 
schon	  ss o: n 
schöne	  ss ui: n @ 
schonend	  ss o: n @ n t 
schönes	  ss ui: n @ s 
schrauben	  ss r au b @ n 
schreibtisch	  ss r ai b t ii ss 
schrumpfung	  ss r uu m p f uu nn 
schublade	  ss uu b l aa: d @ 
schuhen	  ss u: @ n 
schuld	  ss uu l t 
schulden	  ss uu l d @ n 
schuldig	  ss uu l d ii cc 
schuldner	  ss uu l d n ei 
schule	  ss u: l @ 
schulen	  ss u: l @ n 
schulter	  ss u: l t ei 
schutz	  ss uu t s 
schützen	  ss yy t s @ n 
schutzhülle	  ss uu t s h yy l @ 
schwämme	  ss v ee m @ 
schweiz	  ss v ai t s 
schwer	  ss v e: r 
schwierig	  ss v i: r ii cc 
schwieriger	  ss v i: r ii g ei 
schwieriges	  ss v i: r ii g @ s 
schwierigkeiten	  ss v i: r ii cc k ai t @ n 
schwimmen	  ss v ii m @ n 
sechs	  z ee k s 
sechshundert	  z ee k s h uu n d @ r t 
sechshundertfünfzigtausend	  z ee k s h uu n d ei t f yy n f t s ii cc t au z @ n t 
sechzig	  z ee cc t s ii cc 
see	  z e: 
sehe	  z e: @ 
sehen	  z e: @ n 
sehr	  z e: r 
sein	  z ai n 
seine	  z ai n @ 
seiner	  z ai n ei 
seit	  z ai t 
seite	  z ai t @ 
seiten	  z ai t @ n 
selbst	  z ee l p s t 
selbstverständlich	  z ee l p s t f ee r ss t ee n d l ii cc 
selbstverständlichkeit	  z ee l p s t f ee r ss t ee n d l ii cc k ai t 
selbstverwirklichung	  z ee l p s t f ee r v ii r k l ii cc uu nn 
selten	  z ee l t @ n 
seltener	  z ee l t @ n ei 
seltsam	  z ee l t z aa: m 
sendung	  z ee n d uu nn 
setzt	  z ee t s t 
sich	  z ii cc 
sicher	  z ii cc ei 
sichere	  z ii cc @ r @ 
sicherer	  z ii cc @ r ei 
sicherheit	  z ii cc ei h ai t 
sicherheitszentrale	  z ii cc ei h ai t s t s @ n t r aa: l @ 
sicherlich	  z ii cc ei l ii cc 
sicherung	  z ii cc @ r uu nn 
sicht	  z ii cc t 
sichtbar	  z ii cc t b aa: r 
sichtweise	  z ii cc t v ai z @ 
sichtweite	  z ii cc t v ai t @ 
sie	  z i: 
sieben	  z i: b @ n 
siebenhundert	  z i: b @ n h uu n d @ r t 
siebentausendfünfhundert	  z i: b @ n t au z @ n d f yy n f h uu n d @ r t 
siebzehn	  z i: b t s e: n 
siebzig	  z i: b t s ii cc 
siedlungen	  z i: d l uu nn @ n 
sieht	  z i: t 
sind	  z ii n t 
sinken	  z ii nn k @ n 
sinnvoll	  z ii n f oo l 
situation	  z i: t u: a t s ii o: n 
situationen	  z i: t u: a t s ii o: n @ n 
sitz	  z ii t s 
sitzen	  z ii t s @ n 
sitzung	  z ii t s uu nn 
skandal	  s k a n d aa: l 
so	  z o: 
sofort	  z o: f oo r t 
sofortigen	  z o: f oo r t ii g @ n 
sogar	  z o: g aa: r 
solche	  z oo l cc @ 
solchen	  z o: l cc @ n 
solcher	  z oo l cc ei 
solches	  z oo l cc @ s 
soldaten	  z oo l d aa: t @ n 
soll	  z oo l 
sollen	  z oo l @ n 
sollte	  z oo l t @ 
sollten	  z oo l t @ n 
sondern	  z oo n d @ r n 
sonne	  z oo n @ 
sonnenenergie	  z oo n @ n ee n ei g i: 
sonst	  z o: n s t 
sorgen	  z oo r g @ n 
sorgte	  z oo r g t @ 
sorten	  s qq oo r t @ n 
souverän	  z u: v e: r ee: n 
sowieso	  z o: v i: z o: 
sowjetunion	  z oo v j e: t u: n j o: n 
soziale	  z o: t s i: aa: l @ 
sozialen	  z o: t s i: aa: l @ n 
sozialstaat	  z o: t s i: a l s t aa: t 
sozusagen	  z o: t s u: z aa: g @ n 
spanien	  ss p a n ii @ n 
spannend	  ss p a n @ n t 
spannungen	  ss p a n uu nn @ n 
sparen	  ss p aa: r @ n 
sparsam	  ss p aa: r z aa: m 
spaß	  ss p aa: s 
spät	  ss p ee: t 
später	  ss p ee: t ei 
speichel	  ss p ai cc @ l 
speisen	  ss p ai z @ n 
spekulation	  ss p e: k u: l a t s ii o: n 
spekuliert	  ss p e: k u: l i: r t 
spezialisierten	  ss p e: t s i: a l i: z i: r t @ n 
spezialisten	  ss p e: t s i: a l ii s t @ n 
spezielle	  ss p e: t s j ee l @ 
spezielles	  ss p e: t s j ee l @ s 
spezifische	  ss p e: t s i: f ii ss @ 
spiel	  ss p i: l 
spielen	  ss p i: l @ n 
spielraum	  ss p i: l r au m 
spielt	  ss p i: l t 
spirale	  ss p i: r aa: l @ 
sport	  ss p oo r t 
sprache	  ss p r aa: x @ 
sprechen	  ss p r ee cc @ n 
spülmaschine	  ss p yy l m a ss ii n @ 
staat	  ss t aa: t 
staaten	  ss t aa: t @ n 
staates	  ss t aa: t @ s 
staatlichen	  ss t aa: t l ii cc @ n 
staatsdienst	  ss t aa: t s d i: n s t 
stabil	  ss t a b i: l 
stabilität	  ss t a b i: l i: t ee: t 
stadt	  ss t a t 
städte	  ss t ee t @ 
staffel	  ss t a f @ l 
stammen	  ss t a m @ n 
stammt	  ss t a m t 
stand	  ss t a n t 
standard	  ss t a n d a r t 
standen	  ss t a n d @ n 
ständig	  ss t ee n d ii cc 
ständige	  ss t ee n d ii g @ 
stark	  ss t a r k 
starke	  ss t a r k @ 
starken	  ss t a r k @ n 
starker	  ss t a r k ei 
stärker	  ss t ee r k ei 
stärkste	  ss t ee r k s t @ 
statistik	  ss t a t ii s t i: k 
statistiken	  ss t a t ii s t i: k @ n 
stattfinden	  ss t a t f ii n d @ n 
status	  ss t a t uu s 
staub	  ss t au p 
staunen	  ss t au n @ n 
stecken	  ss t ee k @ n 
stehen	  ss t e: @ n 
steht	  ss t e: t 
steigen	  ss t ai g @ n 
steigenden	  ss t ai g @ n d @ n 
steigerungen	  ss t ai g @ r uu nn @ n 
steigt	  ss t ai k t 
stelle	  ss t ee l @ 
stellen	  ss t ee l @ n 
stellt	  ss t ee l t 
stellungnahme	  ss t ee l uu nn n aa: m @ 
sterben	  ss t ee r b @ n 
steuer	  ss t oy ei 
steuerlich	  ss t oy ei l ii cc 
steuern	  ss t oy @ r n 
steuerprogression	  ss t oy ei p r oo g r ee s j o: n 
stiftung	  ss t ii f t uu nn 
stil	  ss t i: l 
still	  ss t ii l 
stillstand	  ss t ii l s t a n t 
stimmen	  ss t ii m @ n 
stimmt	  ss t ii m t 
stimmung	  ss t ii m uu nn 
stoff	  ss t oo f 
stoffe	  ss t oo f @ 
stoffwechsel	  ss t oo f v ee cc z @ l 
stoppen	  ss t oo p @ n 
stört	  ss t ui r t 
stoßen	  ss t o: s @ n 
stößt	  ss t ui s t 
strategie	  ss t r a t e: g i: 
strategien	  ss t r a t e: g i: @ n 
streik	  ss t r ai k 
stress	  ss t r ee s 
strom	  ss t r o: m 
stückzahlen	  ss t yy k t s aa: l @ n 
studien	  ss t u: d ii @ n 
studieren	  ss t u: d i: r @ n 
studium	  ss t u: d i: uu m 
stufe	  ss t u: f @ 
stuhl	  ss t u: l 
stunde	  ss t uu n d @ 
stunden	  ss t uu n d @ n 
stürzen	  ss t yy r t s @ n 
stürzt	  ss t yy r t s t 
subjektiv	  z uu b j ee k t i: f 
subventionen	  z uu b v @ n t s ii o: n @ n 
subventioniert	  z uu b v @ n t s ii o: n i: r t 
suche	  z u: x @ 
suchen	  z u: x @ n 
südeuropa	  z y: d oy r o: p aa: 
summe	  z uu m @ 
summen	  z uu m @ n 
sympathisch	  z yy m p a t h ii ss 
symptome	  z yy m p t o: m @ 
system	  z ii s t ee m 
systeme	  z ii s t ee m @ 
szenario	  s t s e: n a r ii o: 
tabak	  t a b aa: k 
tabelle	  t a b ee l @ 
tag	  t aa: g 
tage	  t aa: g @ 
tagen	  t aa: g @ n 
tages	  t aa: g @ s 
täglichen	  t ee: g l ii cc @ n 
talfahrt	  t a l f aa: r t 
tätigkeit	  t ee: t ii cc k ai t 
tätigkeiten	  t ee: t ii cc k ai t @ n 
tatsache	  t a t z a x @ 
tatsächlich	  t a t z ee cc l ii cc 
tauschhandel	  t au ss h a n d @ l 
täuschung	  t oy ss uu nn 
tausende	  t au z @ n d @ 
technologien	  t ee cc n o: l o: g i: @ n 
teil	  t ai l 
teile	  t ai l @ 
teilgebiet	  t ai l g e: b i: t 
teilnehmer	  t ai l n e: m ei 
teilweise	  t ai l v ai z @ 
telefon	  t e: l e: f o: n 
telefonische	  t e: l e: f o: n ii ss @ 
tempo	  t ee m p o: 
terror	  t ee r o: r 
terroristen	  t ee r o: r ii s t @ n 
test	  t ee s t 
teuer	  t oy ei 
teure	  t oy r @ 
teurer	  t oy r ei 
text	  t ee k s t 
textbausteine	  t ee k s t b au s t ai n @ 
thema	  t e: m aa: 
themen	  t e: m @ n 
theorie	  t e: o: r i: 
these	  t e: z @ 
tief	  t i: f 
tiefe	  t i: f @ 
tiefpunkt	  t i: f p uu nn k t 
tiere	  t i: r @ 
tisch	  t ii ss 
tomaten	  t o: m aa: t @ n 
tonnen	  t oo n @ n 
töpfe	  t ui p f @ 
toskana	  t oo s k a n aa: 
total	  t o: t aa: l 
totalen	  t o: t aa: l @ n 
traditionellen	  t r a d i: t s ii o: n ee l @ n 
tragen	  t r aa: g @ n 
tragend	  t r aa: g @ n t 
transaktionen	  t r a n z a k t s ii o: n @ n 
transportiert	  t r a n s p oo r t i: r t 
traubensaft	  t r au b @ n z a f t 
traurig	  t r au r ii cc 
treffen	  t r ee f @ n 
treiben	  t r ai b @ n 
treibt	  t r ai p t 
trend	  t r ee n t 
treten	  t r e: t @ n 
tricks	  t r ii k s 
trifft	  t r ii f t 
triumph	  t r i: uu m f 
trocken	  t r oo k @ n 
trockene	  t r oo k @ n @ 
trotzdem	  t r oo t s d @ m 
trübung	  t r y: b uu nn 
tschechoslowakei	  t e: ss ee cc oo s l o: v a k ai 
tun	  t u: n 
tut	  t u: t 
typen	  t y: p @ n 
typisch	  t y: p ii ss 
typische	  t y: p ii ss @ 
typischen	  t y: p ii ss @ n 
über	  qq yy b ei 
Über	  qq yy b ei 
überall	  qq y: b ei qq a l 
überarbeitet	  qq y: b ei qq a r b ai t @ t 
Überbringer	  qq y: b ei b r ii nn ei 
Überfluss	  qq y: b ei f l uu s 
überfordert	  qq y: b ei f oo r d @ r t 
Übergang	  qq y: b ei g a nn 
überhäuft	  qq y: b ei h oy f t 
überhaupt	  qq y: b ei h au p t 
überholt	  qq y: b ei h oo l t 
überlassen	  qq y: b ei l a s @ n 
überleben	  qq y: b ei l e: b @ n 
Überleben	  qq y: b ei l e: b @ n 
übernehmen	  qq y: b ei n e: m @ n 
übernommen	  qq y: b ei n oo m @ n 
überprüft	  qq y: b ei p r yy f t 
überraschend	  qq y: b ei qq r a ss @ n t 
überrascht	  qq y: b ei qq r a ss t 
Überraschung	  qq y: b ei qq r a ss uu nn 
überschätzen	  qq y: b ei ss ee t s @ n 
überschritten	  qq y: b ei ss r ii t @ n 
Übersicht	  qq y: b ei z ii cc t 
übersichtlich	  qq y: b ei z ii cc t l ii cc 
überteuert	  qq y: b ei t oy @ r t 
überwacht	  qq y: b ei v a x t 
Überweisung	  qq y: b ei v ai z uu nn 
überwiesen	  qq y: b ei v i: z @ n 
überwunden	  qq y: b ei v uu n d @ n 
überzeugen	  qq y: b ei t s oy g @ n 
üblich	  qq y: b l ii cc 
übliche	  qq y: b l ii cc @ 
übrig	  qq yy b r ii cc 
Übrigen	  qq yy b r ii g @ n 
uhr	  qq u: r 
um	  qq uu m 
umbruch	  uu m b r uu x 
umbrüche	  uu m b r yy cc @ 
umfang	  uu m f a nn 
umfangreiche	  uu m f a nn g r ai cc @ 
umfangreichen	  uu m f a nn g r ai cc @ n 
umfangreicher	  uu m f a nn g r ai cc ei 
umfassend	  uu m f a s @ n t 
umfassende	  uu m f a s @ n d @ 
umgang	  uu m g a nn 
umgebaut	  qq uu m g @ b au t 
umgegangen	  qq uu m g @ g a nn @ n 
umgehen	  uu m g e: @ n 
umgelenkt	  qq uu m g @ l ee nn k t 
umgeschaut	  qq uu m g @ ss au t 
umgeschrieben	  qq uu m g @ ss r i: b @ n 
umgesetzt	  qq uu m g @ z ee t s t 
umkehren	  uu m k e: r @ n 
umlauf	  uu m l au f 
umsatz	  uu m z a t s 
umsonst	  uu m z o: n s t 
umsteigen	  qq uu m ss t ai g @ n 
umstellung	  qq uu m ss t ee l uu nn 
umstritten	  uu m ss t r ii t @ n 
umtauschen	  uu m t au ss @ n 
umwelt	  uu m v ee l t 
unangenehm	  qq uu n qq a n g @ n e: m 
unbedingt	  qq uu n b @ d ii nn t 
unbeeindruckt	  qq uu n b @ qq ai n d r uu k t 
unbegrenzt	  qq uu n b @ g r ee n t s t 
unbeliebt	  qq uu n b @ l i: p t 
unbequeme	  qq uu n b @ k v e: m @ 
unbeschädigt	  qq uu n b @ ss ee: d ii cc t 
und	  qq uu n t 
unendlich	  qq uu n qq ee n t l ii cc 
unendliche	  qq uu n qq ee n d l ii cc @ 
unerwünscht	  qq uu n qq ee r v yy n ss t 
ungefähr	  qq uu n g @ f e: r 
ungeprüft	  qq uu n g @ p r yy f t 
ungewöhnlich	  qq uu n g @ v ui: n l ii cc 
ungewöhnliche	  qq uu n g @ v ui: n l ii cc @ 
ungleichgewichte	  qq uu n g l ai cc g e: v ii cc t @ 
ungleichheiten	  qq uu n g l ai cc h ai t @ n 
union	  qq u: n j o: n 
unmenschlich	  qq uu n m ee n ss l ii cc 
unmöglich	  qq uu n m ui: g l ii cc 
unregelmäßigen	  qq uu n qq r e: g @ l m ee: s ii g @ n 
unruhen	  qq uu n qq r u: @ n 
uns	  qq uu n s 
unsaubere	  qq uu n z au b @ r @ 
unsere	  qq uu n z r @ 
unsicher	  qq uu n z ii cc ei 
unsinn	  qq uu n z ii n 
unten	  qq uu n t @ n 
unter	  qq uu n t ei 
unterbrochen	  qq uu n t ei b r oo x @ n 
unterführung	  qq uu n t ei f y: r uu nn 
untergang	  qq uu n t ei g a nn 
untergegangen	  qq uu n t ei g @ g a nn @ n 
untergehen	  qq uu n t ei g e: @ n 
unterhalt	  qq uu n t ei h a l t 
unterlagen	  qq uu n t ei l aa: g @ n 
unternehmen	  qq uu n t ei n e: m @ n 
unternommen	  qq uu n t ei n oo m @ n 
unterschätzen	  qq uu n t ei ss ee t s @ n 
unterschätzt	  qq uu n t ei ss ee t s t 
unterscheiden	  qq uu n t ei ss ai d @ n 
unterschied	  qq uu n t ei ss i: t 
unterschiede	  qq uu n t ei ss i: d @ 
unterschieden	  qq uu n t ei ss i: d @ n 
unterschiedlich	  qq uu n t ei ss i: d l ii cc 
unterschiedliche	  qq uu n t ei ss i: d l ii cc @ 
unterstützt	  qq uu n t ei ss t yy t s t 
unterstützung	  qq uu n t ei ss t yy t s uu nn 
untersucht	  qq uu n t ei z u: x t 
unverzüglich	  qq uu n f ee r t s y: g l ii cc 
unwahrscheinlich	  qq uu n v aa: r ss ai n l ii cc 
unzählige	  qq uu n t s e: l ii g @ 
unzufrieden	  qq uu n t s u: f r i: d @ n 
unzumutbar	  qq uu n t s u: m u: t b aa: r 
ursache	  qq uu r z a x @ 
ursachen	  qq uu r z a x @ n 
ursprünglich	  qq uu r s p r yy nn l ii cc 
urteil	  qq uu r t ai l 
variante	  v a r i: a n t @ 
varianten	  v a r i: a n t @ n 
vater	  v aa: t ei 
venezuela	  v e: n e: t s u: e: l a 
verabschiedet	  f ee r qq a p ss i: d @ t 
verändern	  f ee r qq ee n d @ r n 
verändert	  f ee r qq ee n d @ r t 
veränderung	  f ee r qq ee n d @ r uu nn 
veränderungen	  f ee r qq ee n d @ r uu nn @ n 
verantwortung	  f ee r qq a n t v oo r t uu nn 
verarbeiten	  f ee r qq a r b ai t @ n 
verarbeitet	  f ee r qq a r b ai t @ t 
verarbeitung	  f ee r qq a r b ai t uu nn 
verarmt	  f ee r qq a r m t 
veräußert	  f ee r qq oy s @ r t 
verbessern	  f ee r b ee s @ r n 
verbessert	  f ee r b ee s @ r t 
verbietet	  f ee r b i: t @ t 
verbindlichkeiten	  f ee r b ii n d l ii cc k ai t @ n 
verbindung	  f ee r b ii n d uu nn 
verbindungen	  f ee r b ii n d uu nn @ n 
verborgen	  f ee r b oo r g @ n 
verbot	  f ee r b o: t 
verboten	  f ee r b o: t @ n 
verbrauch	  f ee r b r au x 
verbraucht	  f ee r b r au x t 
verbrecherbanden	  f ee r b r ee cc ei b a n d @ n 
verbreiten	  f ee r b r ai t @ n 
verbreitet	  f ee r b r ai t @ t 
verbunden	  f ee r b uu n d @ n 
verdacht	  f ee r d a x t 
verdienen	  f ee r d i: n @ n 
verdient	  f ee r d i: n t 
verdoppeln	  f ee r d oo p @ l n 
verdoppelt	  f ee r d oo p @ l t 
verdorben	  f ee r d oo r b @ n 
vereinbaren	  f ee r ai n b aa: r @ n 
vereinbart	  f ee r qq ai n b a r t 
vereinbarung	  f ee r qq ai n b a r uu nn 
verfahren	  f ee r f aa: r @ n 
verfallen	  f ee r f a l @ n 
verfälscht	  f ee r f ee l ss t 
verfassung	  f ee r f a s uu nn 
verfehlt	  f ee r f e: l t 
verfolgen	  f ee r f oo l g @ n 
verfügbar	  f ee r f y: g b aa: r 
verfügung	  f ee r f y: g uu nn 
verfüttert	  f ee r f yy t @ r t 
vergangenen	  f ee r g a nn @ n @ n 
vergangenheit	  f ee r g a nn @ n h ai t 
vergessen	  f ee r g ee s @ n 
vergiftung	  f ee r g ii f t uu nn 
vergleich	  f ee r g l ai cc 
vergleichen	  f ee r g l ai cc @ n 
verglichen	  v ee r g l ii cc @ n 
vergütet	  f ee r g y: t @ t 
verhält	  f ee r h ee l t 
verhalten	  f ee r h a l t @ n 
verhältnis	  f ee r h ee l t n ii s 
verhältnisse	  f ee r h ee l t n ii s @ 
verhandeln	  f ee r h a n d @ l n 
verheiratet	  f ee r h ai r aa: t @ t 
verhindern	  f ee r h ii n d @ r n 
verhindert	  f ee r h ii n d @ r t 
verhungert	  f ee r h uu nn @ r t 
verkauf	  f ee r k au f 
verkäufe	  f ee r k oy f @ 
verkaufen	  f ee r k au f @ n 
verkäufer	  f ee r k oy f ei 
verkauft	  f ee r k au f t 
verkehr	  f ee r k e: r 
verkleinert	  f ee r k l ai n @ r t 
verkraften	  f ee r k r a f t @ n 
verlangen	  f ee r l a nn @ n 
verlängert	  f ee r l ee nn @ r t 
verlangsamt	  f ee r l a nn z aa: m t 
verlangt	  f ee r l a nn t 
verlassen	  f ee r l a s @ n 
verlauf	  f ee r l au f 
verläuft	  f ee r l oy f t 
verlegt	  f ee r l e: k t 
verlief	  f ee r l i: f 
verlieren	  f ee r l i: r @ n 
verlierer	  f ee r l i: r ei 
verlierern	  f ee r l i: r @ r n 
verliert	  f ee r l i: r t 
verloren	  f ee r l o: r @ n 
verlust	  f ee r l uu s t 
verluste	  f ee r l uu s t @ 
vermehren	  f ee r m e: r @ n 
vermeiden	  f ee r m ai d @ n 
vermieden	  f ee r m i: d @ n 
vermieter	  f ee r m i: t ei 
vermietet	  f ee r m i: t @ t 
vermittler	  f ee r m ii t l ei 
vermögen	  f ee r m ui: g @ n 
vermögens	  f ee r m ui: g @ n s 
vermutlich	  f ee r m u: t l ii cc 
vermutung	  f ee r m u: t uu nn 
vernachlässigt	  f ee r n a x l ee s ii cc t 
vernichtendes	  f ee r n ii cc t @ n d @ s 
vernichtet	  f ee r n ii cc t @ t 
vernünftigen	  f ee r n yy n f t ii g @ n 
vernünftiger	  f ee r n yy n f t ii g ei 
vernünftiges	  f ee r n yy n f t ii g @ s 
veröffentlichen	  f ee r qq ui f @ n t l ii cc @ n 
veröffentlicht	  f ee r qq ui f @ n t l ii cc t 
verpackung	  f ee r p a k uu nn 
verpackungen	  f ee r p a k uu nn @ n 
verpackungseinheit	  f ee r p a k uu nn s qq ai n h ai t 
verpflichtungen	  f ee r p f l ii cc t uu nn @ n 
verringert	  f ee r qq r ii nn @ r t 
verringerte	  f ee r qq r ii nn @ r t @ 
versagt	  f ee r z aa: g t 
versand	  f ee r z a n t 
verschärfung	  f ee r ss ee r f uu nn 
verschiedene	  f ee r ss i: d @ n @ 
verschiedenen	  f ee r ss i: d @ n @ n 
verschiedenster	  f ee r ss i: d @ n s t ei 
verschleiert	  f ee r ss l ai ei t 
verschlossen	  f ee r ss l oo s @ n 
verschlüsse	  f ee r ss l yy s @ 
verschulden	  f ee r ss uu l d @ n 
verschuldet	  f ee r ss uu l d @ t 
verschuldung	  f ee r ss uu l d uu nn 
verschwiegen	  f ee r ss v i: g @ n 
verschwinden	  f ee r ss v ii n d @ n 
verschwunden	  f ee r ss v uu n d @ n 
versehen	  f ee r z e: @ n 
versicherung	  f ee r z ii cc @ r uu nn 
version	  f ee r z ii o: n 
versorgen	  f ee r z oo r g @ n 
versorgt	  f ee r z oo r k t 
versorgung	  f ee r z oo r g uu nn 
versprechen	  f ee r ss p r ee cc @ n 
versprochen	  f ee r ss p r oo x @ n 
verstanden	  f ee r ss t a n d @ n 
verständnisvoll	  f ee r ss t ee n d n ii s f oo l 
verstecken	  f ee r ss t ee k @ n 
verstehe	  f ee r ss t e: @ 
verstehen	  f ee r ss t e: @ n 
versteigert	  f ee r ss t ai g @ r t 
versuche	  f ee r z u: x @ 
versuchen	  f ee r z u: x @ n 
versucht	  f ee r z u: x t 
verteidigen	  f ee r t ai d ii g @ n 
verteilt	  f ee r t ai l t 
verteilung	  f ee r t ai l uu nn 
vertrag	  f ee r t r aa: k 
vertrauen	  f ee r t r au @ n 
vertrauensvoll	  f ee r t r au @ n s f oo l 
vertreten	  f ee r t r e: t @ n 
vertrieben	  f ee r t r i: b @ n 
vertuschen	  f ee r t uu ss @ n 
verunsichert	  f ee r qq uu n z ii cc @ r t 
verursacher	  f ee r qq uu r z a x ei 
verursacht	  f ee r qq uu r z a x t 
verwandelt	  f ee r v a n d @ l t 
verweigert	  f ee r v ai g @ r t 
verwenden	  f ee r v ee n d @ n 
verwendet	  f ee r v ee n d @ t 
verwendung	  f ee r v ee n d uu nn 
verwerfungen	  f ee r v ee r f uu nn @ n 
verwertet	  f ee r v ee r t @ t 
verwirrt	  f ee r v ii r t 
verzeichnis	  f ee r t s ai cc n ii s 
verzichten	  f ee r t s ii cc t @ n 
verzichtet	  f ee r t s ii cc t @ t 
verzögert	  f ee r t s ui: g @ r t 
verzögerungen	  f ee r t s ui: g @ r uu nn @ n 
viehfutter	  f i: h f uu t ei 
viel	  f i: l 
viele	  f i: l @ 
vielen	  f i: l @ n 
vieles	  f i: l @ s 
vielfaches	  f i: l f a x @ s 
vielleicht	  f i: l l ai cc t 
vier	  f i: r 
vierhundertfünfzig	  f i: r h uu n d ei t f yy n f t s ii cc 
volk	  f oo l k 
voll	  f oo l 
volle	  f oo l @ 
vollkommen	  f oo l k oo m @ n 
vollkommener	  f oo l k oo m @ n ei 
vollständig	  f oo l ss t ee n d ii cc 
vollständigen	  f oo l ss t ee n d ii g @ n 
vom	  f oo m 
von	  f oo n 
vor	  f oo r 
voran	  f o: r qq a n 
vorausgesagt	  f o: r au s g @ z aa: g t 
vorausgesehen	  f o: r au s g @ z e: @ n 
vorausgesetzt	  f o: r au s g @ z ee t s t 
voraussetzungen	  f o: r au s z ee t s uu nn @ n 
voraussichtlich	  f o: r au s z ii cc t l ii cc 
vorbei	  f o: r b ai 
vorbereiten	  f o: r b @ qq r ai t @ n 
vorbereitet	  f o: r b @ qq r ai t @ t 
vorbeugen	  f o: r b oy g @ n 
vorbeugung	  f o: r b oy g uu nn 
vorgang	  f o: r g a nn 
vorgänge	  f o: r g ee nn @ 
vorgegaukelt	  f o: r g @ g au k @ l t 
vorgelegt	  f o: r g @ l e: k t 
vorgerechnet	  f o: r g @ qq r ee cc n @ t 
vorgeschoben	  f o: r g @ ss o: b @ n 
vorgestellt	  f o: r g @ ss t ee l t 
vorhanden	  f o: r h a n d @ n 
vorhang	  f o: r h a nn 
vorher	  f o: r h e: r 
vorhergesagt	  f o: r h e: r g @ z aa: g t 
vorhergesehen	  f o: r h e: r g @ z e: @ n 
vorherigen	  f o: r h e: r ii cc @ n 
vorhersagen	  f o: r h e: r z aa: g @ n 
vorjahr	  f o: r j aa: r 
vorkenntnisse	  f o: r k ee n t n ii s @ 
vorkommen	  f o: r k oo m @ n 
vorliegen	  f o: r l i: g @ n 
vorne	  v oo r n @ 
vorrat	  f o: r qq r aa: t 
vorräte	  f o: r qq r ee: t @ 
vorratslager	  f o: r qq r a t s l aa: g ei 
vorschein	  f o: r ss ai n 
vorschuss	  f o: r ss uu s 
vorsichtig	  f o: r z ii cc t ii cc 
vorsorge	  f o: r z oo r g @ 
vorsorgen	  f o: r z oo r g @ n 
vorstellung	  f o: r ss t ee l uu nn 
vorstellungsgespräch	  f o: r ss t ee l uu nn s g @ s p r ee cc 
vorteil	  f o: r t ai l 
vorteile	  f o: r t ai l @ 
vorteilhaft	  f o: r t ai l h a f t 
vorübergehend	  f o: r yy b ei g e: @ n t 
vorurteil	  f o: r qq uu r t ai l 
vorwand	  f o: r v a n t 
vorwürfe	  f o: r v yy r f @ 
vorzeichen	  f o: r t s ai cc @ n 
vorzeitig	  f o: r t s ai t qq i: k 
vorzubeugen	  f o: r t s u: b oy g @ n 
wachsen	  v a k s @ n 
wächst	  v ee cc s t 
wachstum	  v a x s t u: m 
wahlen	  v aa: l @ n 
wahlmöglichkeiten	  v aa: l m ui g l ii cc k ai t @ n 
wahr	  v aa: r 
wahre	  v aa: r @ 
während	  v e: r @ n t 
wahrgenommen	  v aa: r g @ n oo m @ n 
wahrheit	  v aa: r h ai t 
wahrheitsgehalt	  v aa: r h ai t s g e: a l t 
wahrnehmung	  v aa: r n e: m uu nn 
wahrscheinlich	  v aa: r ss ai n l ii cc 
wahrscheinlichkeit	  v aa: r ss ai n l ii cc k ai t 
währung	  v e: r uu nn 
währungen	  v e: r uu nn @ n 
währungspolitik	  v e: r uu nn s p o: l i: t i: k 
wand	  v a n t 
wandern	  v a n d @ r n 
wann	  v a n 
war	  v aa: r 
ware	  v aa: r @ 
wäre	  v ee: r @ 
waren	  v aa: r @ n 
wären	  v ee: r @ n 
warnsignal	  v a r n z ii g n aa: l 
warnungen	  v a r n uu nn @ n 
warten	  v a r t @ n 
warum	  v aa: r uu m 
was	  v a s 
wasser	  v a s ei 
weg	  v e: k 
wege	  v e: g @ 
wegezoll	  v e: g e: t s oo l 
weggenommen	  v e: k g @ n oo m @ n 
weggeworfen	  v e: k g @ v oo r f @ n 
wehren	  v e: r @ n 
weich	  v ai cc 
weiche	  v ai cc @ 
weile	  v ai l @ 
weise	  v ai z @ 
weiß	  v ai s 
weist	  v ai s t 
weit	  v ai t 
weiter	  v ai t ei 
weitere	  v ai t ei @ 
weiteren	  v ai t ei @ n 
weiterer	  v ai t ei ei 
weiteres	  v ai t ei @ s 
weitergeben	  v ai t @ r g e: b @ n 
weitergegeben	  v ai t @ r g @ g e: b @ n 
weitergehen	  v ai t @ r g e: @ n 
weiterhin	  v ai t @ r h ii n 
weizen	  v ai t s @ n 
welche	  v ee l cc @ 
welchen	  v e: l cc @ n 
welcher	  v ee l cc ei 
welches	  v ee l cc @ s 
welle	  v ee l @ 
welt	  v ee l t 
welthandel	  v ee l t a n d @ l 
weltlage	  v ee l t l aa: g @ 
weltweit	  v ee l t v ai t 
weltweite	  v ee l t v ai t @ 
wenden	  v ee n d @ n 
wenig	  v e: n ii cc 
wenige	  v e: n ii g @ 
wenigen	  v e: n ii g @ n 
weniger	  v e: n ii g ei 
wenigsten	  v e: n ii cc s t @ n 
wer	  v e: r 
werde	  v ee r d @ 
werden	  v ee r d @ n 
werdet	  v ee r d @ t 
werfen	  v ee r f @ n 
werkzeuge	  v ee r k t s oy g @ 
wert	  v ee r t 
werte	  v ee r t @ 
werten	  v ee r t @ n 
wertverlust	  v ee r t v ei l uu s t 
wertvolle	  v ee r t f oo l @ 
wertvollen	  v ee r t f oo l @ n 
wertvoller	  v ee r t f oo l ei 
wertvolles	  v ee r t f oo l @ s 
wesentlich	  v e: z @ n t l ii cc 
wesentlichen	  v e: z @ n t l ii cc @ n 
wesentlicher	  v e: z @ n t l ii cc ei 
wesentliches	  v e: z @ n t l ii cc @ s 
westen	  v ee s t @ n 
westeuropa	  v ee s t oy r o: p aa: 
westlichen	  v ee s t l ii cc @ n 
wettbewerb	  v ee t b e: v @ r p 
wichtig	  v ii cc t ii cc 
wichtige	  v ii cc t ii g @ 
wichtigen	  v ii cc t ii g @ n 
wichtiger	  v ii cc t ii g ei 
wichtiges	  v ii cc t ii g @ s 
wichtigste	  v ii cc t ii cc s t @ 
widersprochen	  v i: d ei s p r oo x @ n 
widersprüchlich	  v i: d ei s p r yy cc l ii cc 
widersprüchlichen	  v i: d ei s p r yy cc l ii cc @ n 
widerstand	  v i: d ei s t a n t 
widerstände	  v i: d ei s t ee n d @ 
widmen	  v ii d m @ n 
wie	  v i: 
wieder	  v i: d ei 
wiederholt	  v i: d ei h oo l t 
wiederkommen	  v i: d ei k oo m @ n 
will	  v ii l 
willkommen	  v ii l k oo m @ n 
wir	  v i: r 
wird	  v ii r t 
wirken	  v ii r k @ n 
wirklich	  v ii r k l ii cc 
wirkliche	  v ii r k l ii cc @ 
wirklichkeit	  v ii r k l ii cc k ai t 
wirksamer	  v ii r k z aa: m ei 
wirkt	  v ii r k t 
wirtschaft	  v ii r t ss a f t 
wirtschaftliche	  v ii r t ss a f t l ii cc @ 
wirtschaftlichen	  v ii r t ss a f t l ii cc @ n 
wirtschaftlicher	  v ii r t ss a f t l ii cc ei 
wirtschaftskrise	  v ii r t ss a f t s k r ii s @ 
wirtschaftsmacht	  v ii r t ss a f t s m a x t 
wirtschaftswachstum	  v ii r t ss a f t s v a x s t u: m 
wissen	  v ii s @ n 
wissenschaftler	  v ii s @ n ss a f t l ei 
wo	  v o: 
woanders	  v o: a n d ei s 
woche	  v oo x @ 
wofür	  v o: f y: r 
woher	  v o: h e: r 
wohl	  v o: l 
wohlstand	  v o: l ss t a n t 
wohnung	  v o: n uu nn 
wohnungen	  v o: n uu nn @ n 
wolfenbüttel	  v oo l f @ n b yy t @ l 
wolken	  v oo l k @ n 
wollen	  v oo l @ n 
wollte	  v oo l t @ 
wollten	  v oo l t @ n 
womit	  v o: m ii t 
worauf	  v o: r au f 
worden	  v oo r d @ n 
wovon	  v o: v o: n 
wozu	  v o: t s u: 
wunden	  v uu n d @ n 
wunderbar	  v uu n d ei b aa: r 
wundern	  v uu n d @ r n 
wünscht	  v yy n ss t 
wurde	  v uu r d @ 
würde	  v yy r d @ 
wurden	  v uu r d @ n 
wurst	  v u: r s t 
wurstsalat	  v uu r s t z a l aa: t 
wusste	  v uu s t @ 
wussten	  v uu s t @ n 
zahl	  t s aa: l 
zahlen	  t s aa: l @ n 
zahlreiche	  t s aa: l r ai cc @ 
zählt	  t s e: l t 
zahlung	  t s aa: l uu nn 
zahlungen	  t s aa: l uu nn @ n 
zahlungsmittel	  t s aa: l uu nn s m ii t @ l 
zahlungsverzug	  t s aa: l uu nn s v ei t s u: k 
zaun	  t s au n 
zeche	  t s ee cc @ 
zehn	  t s e: n 
zeichen	  t s ai cc @ n 
zeichnung	  t s ai cc n uu nn 
zeigen	  t s ai g @ n 
zeigt	  t s ai k t 
zeit	  t s ai t 
zeitangabe	  t s ai t qq a n g aa: b @ 
zeitarbeiter	  t s ai t qq a r b ai t ei 
zeitaufwand	  t s ai t qq au f v a n t 
zeiten	  t s ai t @ n 
zeitpunkt	  t s ai t p uu nn k t 
zeitung	  t s ai t qq uu nn 
zentralbanken	  t s ee n t r aa: l b a nn k @ n 
zentrale	  t s ee n t r aa: l @ 
zentrum	  t s ee n t r uu m 
zerbrechen	  t s ee r b r ee cc @ n 
zerbrechlich	  t s ee r b r ee cc l ii cc 
zerbrochen	  t s ee r b r oo x @ n 
zerfall	  t s ee r f a l 
zerfallen	  t s ee r f a l @ n 
zerlegt	  t s ee r l e: k t 
zerstrittenheit	  t s ee r ss t r ii t @ n h ai t 
ziel	  t s i: l 
ziemlich	  t s i: m l ii cc 
zigaretten	  t s i: g a r ee t @ n 
zink	  t s ii nn k 
zins	  t s i: n s 
zinsen	  t s ii n z @ n 
zitiert	  t s i: t i: r t 
zittern	  t s ii t @ r n 
zone	  t s o: n @ 
zu	  t s u: 
zucker	  t s uu k ei 
zufrieden	  t s u: f r i: d @ n 
zufügen	  t s u: f y: g @ n 
zugang	  t s u: g a nn 
zugänglich	  t s u: g ee nn l ii cc 
zugegeben	  t s u: g @ g e: b @ n 
zugelassen	  t s u: g @ l a s @ n 
zugelegt	  t s u: g @ l e: k t 
zugenommen	  t s u: g @ n oo m @ n 
zugesetzt	  t s u: g @ z ee t s t 
zugesprochen	  t s u: g @ ss p r oo x @ n 
zugestimmt	  t s u: g @ ss t ii m t 
zugezogen	  t s u: g @ t s o: g @ n 
zugreifen	  t s u: g r ai f @ n 
zugriff	  t s u: g r ii f 
zukunft	  t s u: k uu n f t 
zum	  t s uu m 
zumindest	  t s u: m ii n d @ s t 
zunächst	  t s u: n ee cc s t 
zunahme	  t s u: n aa: m @ 
zur	  t s u: r 
zurück	  t s u: qq r yy k 
zurückgegangen	  t s u: r yy k g @ g a nn @ n 
zurückgehen	  t s u: r yy k g e: @ n 
zurückgenommen	  t s u: r yy k g @ n oo m @ n 
zurückgeschickt	  t s u: r yy k g @ ss ii k t 
zurückgezahlt	  t s u: r yy k g @ t s aa: l t 
zurückgezogen	  t s u: r yy k g @ t s o: g @ n 
zurückliegenden	  t s u: r yy k l i: g @ n d @ n 
zurücknehmen	  t s u: r yy k n e: m @ n 
zurückzubekommen	  t s u: r yy k t s u: b @ k oo m @ n 
zurzeit	  t s u: qq r t s ai t 
zusammen	  t s u: z a m @ n 
zusammenbrechen	  t s u: z a m @ n b r ee cc @ n 
zusammenbruch	  t s u: z a m @ n b r uu x 
zusammengebrochen	  t s u: z a m @ n g ee b r oo x @ n 
zusammengehalten	  t s u: z a m @ n g e: a l t @ n 
zusammenhalt	  t s u: z a m @ n h a l t 
zusammenhang	  t s u: z a m @ n h a nn 
zusammenhänge	  t s u: z a m @ n h ee nn @ 
zusammenleben	  t s u: z a m @ n l e: b @ n 
zusätzlich	  t s u: z ee t s l ii cc 
zusätzliche	  t s u: z ee t s l ii cc @ 
zusätzlicher	  t s u: z ee t s l ii cc ei 
zusätzliches	  t s u: z ee t s l ii cc @ s 
zuschlagen	  t s u: ss l aa: g @ n 
zuschrift	  t s u: ss r ii f t 
zuschriften	  t s u: ss r ii f t @ n 
zustand	  t s u: ss t a n t 
zustände	  t s u: ss t ee n d @ 
zuständig	  t s u: ss t ee n d ii cc 
zustimmen	  t s u: ss t ii m @ n 
zutaten	  t s u: t aa: t @ n 
zutreffend	  t s u: t r ee f @ n t 
zuvor	  t s u: f oo r 
zuwachs	  t s u: v a k s 
zuzurechnen	  t s u: t s u: qq r ee cc n @ n 
zuzutrauen	  t s u: t s u: t r au @ n 
zwangsläufig	  t s v a nn s l oy f ii cc 
zwangsversteigerung	  t s v a nn s v ei s t ai g @ r uu nn 
zwei	  t s v ai 
zweihunderttausend	  t s v ai h uu n d ei t au z @ n t 
zweimal	  t s v ai m aa: l 
zweitausend	  t s v ai t au z @ n t 
zweitausendacht	  t s v ai t au z ee n d a x t 
zweitausendundfünf	  t s v ai t au z ee n d uu n d f yy n f 
zweitausendundsechs	  t s v ai t au z ee n d uu n d z ee k s 
zweitausendzweihundert	  t s v ai t au z ee n d t s v ai h uu n d @ r t 
zweite	  t s v ai t @ 
zweiundzwanzig	  t s v ai uu n d t s v a n t s ii cc 
zweiundzwanzigtausend	  t s v ai uu n d t s v a n t s ii cc t au z @ n t 
zwischen	  t s v ii ss @ n 
zwölf	  t s v ui l f 
zwölftausend	  t s v ui l f t au z @ n t 
